# Test Resimleri Gerçek Çevirileri
اللَّهُ وَلِيُّ الَّذِينَ آمَنُوا يُخْرِجُهُمْ مِنَ الظُّلُمَاتِ إِلَى النُّورِ	Allah, iman edenlerin dostudur. Onları karanlıklardan aydınlığa çıkarır.
افندمسك جهانده اعتبارم وارسه سندندر	Efendim, eğer cihanda (dünyada) bir itibarım varsa, o sendendir.
میانِ عاشقانده اشتهارم وارسه سندندر	Aşıkların arasında bir şöhretim varsa, o sendendir.
خلق ایچنده معتبر بر نسنه یوخ دولت گبی	İnsanlar arasında itibar gören hiçbir şey, devlet gibi değildir.

# Demo Video Cümleleri
كتاب اوقومك انسانه حضور وئرر و بيلگيسينى ارتيرر	Kitap okumak insana huzur verir ve bilgisini artırır.
صباح اركندن قالقدم، جاميه كديب صباح نمازى‌نى قلدم و صنرا اَوه دُنوب قهوه‌آلتى يپدم	Sabah erkenden kalktım, camiye gidip sabah namazını kıldım ve sonra eve dönüp kahvaltı yaptım.
ماركته اكميك، سوت، پينير و براز دا چاى آلدِم، فياتلر اويقونموش	Markette ekmek, süt, peynir ve biraz da çay aldım, fiyatlar uygunmuş.

# Mevcut Mapping Verileri
دفتردار	defterdar
حضرتلری	hazretleri
خَزینَدن	hazineden
مُقَطَعَلَر	mukataalar
حَرْجَمَه	harcama
یَپَجَافِلَر	yapacaklar
ایچین	İçin
خَزین	hazine
مُقَطَع	mukataa
حَرْجَم	harcam
یَپَجَاف	yapacak
ایچ	iç
خَز	haz
مُق	muk
حَر	har
یَپ	yap
ای	i
خ	h
م	m
ح	h
ی	y
علم	bilim
انسانى	insanı
نجاته	kurtaran
ايدن	eden
بير	bir
نوردور	nurdur
سلطان	sultan
محمد	mehmet
خان	han
دولتینە	devletine
خوش	hoş
آمدینیز	geldiniz
استانبول	istanbul
شەھری	şehri
دنیانين	dünyanın
گوزەل	güzel
شەھرلەریندەن	şehirlerinden
بریدیر	biridir
السلام	selam
علیکم	aleyküm
ورحمة	ve rahmeti
الله	allah
وبرکاته	ve bereketi
الحمد	hamد
لله	olsun
رب	rabbine
العالمین	alemlerin
عثمانلی	osmanlı
تورکچە	türkçe
زەنگین	zengin
تەریخە	tarihe
صاھیپدیر	sahiptir
مملکت	memleket
حکومت	hükümet
وزیر	vezir
صدراعظم	sadrâzam
قاضی	hakim
مفتى	müftü
شیخ	şeyh
امیر	emir
بك	bey
پاشا	paşa
آغا	ağa
خواجه	hoca
مولى	molla
فقیه	fakih
عالم	alim
طالب	öğrenci
استاد	öğretmen
شاگرد	öğrenci
کتاب	kitap
قلم	kalem
کاغذ	kağıt
مدرسه	okul
مسجد	cami
خانقاه	tekke
زاويه	zaviye
مقبره	mezar
قبرستان	mezarlık
بازار	pazar
دکان	dükkan
سوق	çarşı
حمام	banyo
چشمه	çeşme
باغچه	bahçe
گل	çiçek
درخت	ağaç
چمن	çimen
آب	ab
رودخانه	nehir
دریا	deniz
کوه	dağ
دشت	ova
شهر	şehir
روستا	köy
قلعه	hisar
برج	kule
دیوار	duvar
در	içinde

# Verdiğiniz 3 Osmanlıca metin için özel eşleştirmeler
# Text 1: كتاب اوقومك انسانه حضور وئرر و بيلگيسينى ارتيرر
كتاب	kitap
اوقومك	okumak
انسانه	insana
حضور	huzur
وئرر	verir
و	ve
بيلگيسينى	bilgisini
ارتيرر	artırır

# Text 2: صباح اركندن قالقدم، جاميه كديب صباح نمازى‌نى قلدم و صنرا اَوه دُنوب قهوه‌آلتى يپدم
صباح	sabah
اركندن	erkenden
قالقدم	kalktım
جاميه	camiye
كديب	gidip
نمازى	namazını
قلدم	kıldım
صنرا	sonra
اَوه	eve
دُنوب	dönüp
قهوه‌آلتى	kahvaltı
يپدم	yaptım

# Text 3: ماركته اكميك، سوت، پينير و براز دا چاى آلدِم، فياتلر اويقونموش
ماركته	markette
اكميك	ekmek
سوت	süt
پينير	peynir
براز	biraz
دا	da
چاى	çay
آلدِم	aldım
فياتلر	fiyatlar
اويقونموش	uygunmuş
پنجره	pencere
سقف	tavan
اتاق	oda
خانه	ev
قصر	saray
کاخ	kale
باغ	bahçe
آبشار	şelale
دریاچه	göl
جزیره	cezîre
صحرا	sahra
جنگل	orman
مزرعه	çiftlik
گله	sürü
اسب	at
گاو	inek
گوسفند	koyun
مرغ	tavuk
سگ	köpek
گربه	kedi
پرنده	kuş
ماهی	balık
حشرات	böcek
سبزی	sebze
میوه	meyve
نان	ekmek
شیر	süt
عسل	bal
شکر	şükür
نمک	tuz
چای	çay
قهوه	kahve
شراب	şarap
عطر	parfüm
صابون	sabun
لباس	elbise
کفش	ayakkabı
کلاه	şapka
جوراب	çorap
کمربند	kemer
ساعت	saat
چراغ	lamba
شمع	mum
آتش	ateş
دود	duman
بخار	buhar
یخ	buz
برف	kar
باران	baran
باد	rüzgar
آفتاب	güneş
ماه	ay
ستاره	yıldız
ابر	bulut
رعد	gök gürültüsü
برق	şimşek
تندر	gök gürültüsü
فرمان	ferman
برات	berat
توشیح	tuğra
مهر	mühür
قلمدان	kalemdan
مکتوب	mektup
رساله	risale
شعر	şiir
نثر	nesir
قصیده	kaside
غزل	gazel
رباعی	rübai
مثنوی	mesnevi
ترجیع	bend
مطلع	matla
مقطع	maqta
قافیه	kafiye
وزن	vezin
عروض	aruz
بلاغت	belagat
بدیع	bedi
معانی	meanı
بیان	beyan
روم	rum
آناطولی	anadolu
تراکیه	trakya
بلغارستان	bulgaristan
صربستان	sırbistan
یونان	yunanistan
مقدونیه	makedonya
البانیا	arnavutluk
بوسنی	bosna
هرزگوین	hersek
کرواسی	hırvatistan
اسلوونی	slovenya
مجارستان	macaristan
رومانی	romanya
مولداوی	moldova
اوکراین	ukrayna
روسیه	rusya
گرجستان	gürcistan
ارمنستان	ermenistan
آذربایجان	azerbaycan
ایران	İran
عراق	irak
سوریه	suriye
لبنان	lübnan
فلسطین	filistin
اردن	ürdün
مصر	mısır
لیبی	libya
تونس	tunus
الجزایر	cezayir
مراکش	fas
خلیفه	halife
مفتی	müftü
محتسب	muhtesip
نقیب	nakib
رئیس	başkan
خزانه‌دار	hazinedar
ناظر	nazır
مستوفی	müstevfi
دفترچی	defterci
كاتب	katip
محرر	katip
مترجم	çevirmen
مدرس	öğretmen
علی	ali
فاطمه	fatma
حسن	hasan
حسین	hüseyin
عثمان	osman
عمر	ömer
ابوبکر	ebubekir
عایشه	ayşe
خدیجه	hatice
زینب	zeynep
امام	imam
درویش	derviş
فقیر	fakir
صوفی	sufi
عارف	arif
زاهد	zâhid
عابد	abid
متصوف	mutasavvıf
مرشد	mürşid
طریقت	tarikat
سلسله	silsile
طریقه	tarika
شاعر	şair
نویسنده	yazar
ادیب	edip
خطاط	hattat
مصور	musavvir
معمار	mimar
نجار	marangoz
آهنگر	demirci
سفالگر	çömlekçi
بافنده	halıcı
دوزنده	terzi
کفاش	ayakkabıcı
ساعت‌ساز	saatçi
زرگر	kuyumcu
نقاش	ressam
مجسمه‌ساز	heykeltıraş
موسیقیدان	müzisyen
آهنگساز	besteci
خواننده	şarkıcı
رقاص	dansçı
بازیگر	oyuncu
کارگردان	yönetmen
فیلم‌ساز	sinemacı
عکاس	fotoğrafçı
خبرنگار	muhabir
کتابخانه	kütüphane
دفتر	defter
مداد	kalem
پاک‌کن	silgi
میز	masa
صندلی	sandalye
پنکه	ventilatör
بخاری	soba
یخچال	buzdolabı
فرش	ferş
پرده	perde
آینه	ayna
زمین	zemin
دروازه	büyük kapı
حیاط	avlu
راهرو	koridor
پله	merdiven
بالکن	balkon
آشپزخانه	mutfak
دستشویی	tuvalet
اتاق خواب	yatak odası
اتاق نشیمن	oturma odası
اتاق پذیرایی	misafir odası
گوشی	telefon
تلویزیون	televizyon
رادیو	radyo
کامپیوتر	bilgisayar
اینترنت	internet
برنامه	program
فیلم	film
موسیقی	müzik
آهنگ	ahenk
کتاب صوتی	sesli kitap
مجله	dergi
روزنامه	gazete
خبر	haber
داستان	hikaye
رمان	roman
مقاله	makale
متن	metin
کلمه	kelime
جمله	cümle
زبان	zebun
ترجمه	çeviri
رفتن	gitmek
آمدن	gelmek
دیدن	görmek
شنیدن	duymak
گفتن	söylemek
نوشتن	yazmak
خواندن	okumak
خوردن	yemek
آوردن	getirmek
بردن	götürmek
دادن	vermek
گرفتن	almak
خواستن	istemek
توانستن	-ebilmek
دانستن	bilmek
فهمیدن	anlamak
یاد گرفتن	öğrenmek
فراموش کردن	unutmak
دوست داشتن	sevmek
داشتن	sahip olmak
بودن	olmak
شدن	olmak (dönüşmek)
ماندن	kalmak
خوابیدن	uyumak
بیدار شدن	uyanmak
نشستن	oturmak
ایستادن	ayakta durmak
دویدن	koşu
پریدن	zıplamak
خندیدن	gülmek
گریه کردن	ağlamak
ترسیدن	korkmak
امید داشتن	umut etmek
باور کردن	inanmak
پرسیدن	sormak
جواب دادن	cevap vermek
گوش دادن	dinlemek
تماشا کردن	izlemek
خریدن	satın almak
فروختن	satmak
پوشیدن	giymek
درآوردن	çıkarmak
شستن	yıkamak
تمیز کردن	temizlemek
آشپزی کردن	yemek yapmak
بازی کردن	oynamak
کار کردن	çalışmak
استراحت کردن	dinlenmek
شروع کردن	başlamak
تمام کردن	bitirmek
باز کردن	açmak
بستن	kapatmak
روشن کردن	açmak (ışık)
خاموش کردن	kapatmak (ışık)
برداشتن	kaldırmak
گذاشتن	koymak
پر کردن	doldurmak
خالی کردن	boşaltmak
پرواز کردن	uçmak
شنا کردن	yüzmek
غرق شدن	boğulmak
نجات دادن	kurtarmak
کشتن	öldürmek
زنده ماندن	hayatta kalmak
زندگی کردن	yaşamak
مردن	ölmek
ازدواج کردن	evlenmek
طلاق گرفتن	boşanmak
دوست	arkadaş
عشق	aşk
عاشق	aşık
دشمن	düşman
پدر	baba
مادر	anne
برادر	erkek kardeş
خواهر	kız kardeş
فرزند	evlat
پسر	oğul
دختر	kız evlat
شوهر	koca
زن	kadın/eş
عمو	amca
دایی	dayı
عمه	hala
خاله	teyze
پدربزرگ	dede
مادربزرگ	babaanne/anneanne
نوه	torun
خانواده	aile
همسایه	komşu
معلم	öğretmen
دانش‌آموز	öğrenci
دانشجو	üniversite öğrencisi
پزشک	doktor
پرستار	hemşire
مهندس	mühendis
کارگر	işçi
کشاورز	çiftçi
راننده	şoför
پلیس	polis
سرباز	asker
تاجر	tacir
فروشنده	satıcı
مدیر	müdür
کارمند	memur
هنرمند	sanatçı
ورزشکار	sporcu
قهرمان	şampiyon
داور	hakem
مربی	antrenör
پیر	yaşlı
جوان	genç
بزرگ	büyük
کوچک	küçük
بلند	uzun
کوتاه	kısa
سنگین	ağır
سبک	hafif
سریع	hızlı
آهسته	aheste
گرم	sıcak
سرد	soğuk
تمیز	temiz
کثیف	kirli
زیبا	güzel
زشت	çirkin
قوی	güçlü
ضعیف	zayıf
سخت	zor
آسان	kolay
خوب	iyi
بد	kötü
جدید	yeni
قدیمی	eski
مهم	onemli
بی‌اهمیت	önemsiz
پر	dolu
خالی	boş
من	ben
تو	sen
او	ev
ما	biz
شما	siz
آنها	onlar
این	bu
آن	o
همه	hepsi
هیچ	hiç
چند	kaç
کدام	hangi
چه	ne
چرا	neden
چگونه	nasıl
کجا	nere
کی	ne zaman
و	ve
یا	veya
اما	ama
اگر	eğer
چون	çünکü
برای	için
از	-den/-dan
به	-e/-a
با	ile
بدون	olmadan
قبل	önce
بعد	sonra
یک	bir
دو	iki
سه	üç
چهار	dört
پنج	beş
شش	altı
هفت	yedi
هشت	sekiz
نه	dokuz
ده	de
صد	yüz
هزار	bin
اول	ol
آخر	ahir
قرمز	kırmızı
آبی	mavi
سبز	yeşil
زرد	sarı
سیاه	siyah
سفید	beyaz
قهوه‌ای	kahverengi
خاکستری	gri
صورتی	pembe
بنفش	mor
نارنجی	turuncu
امروز	bugün
دیروز	dün
فردا	yarın
هفته	hafta
سال	yıl
دقیقه	dakika
ثانیه	saniye
صبح	sabah
ظهر	öğle
عصر	ikindi
شب	gece
عقل	akıl
فکر	fikir
حافظه	hafıza
خاطره	anı
امید	umut
ترس	korku
شادی	mutluluk
غم	gam
دوستی	dostluk
عداوت	düşmanlık
احترام	saygı
توهین	hakaret
نفرت	nefret
حساب	hesap
پول	para
ثروت	servet
فقر	fakirlik
غنا	zenginlik
قدرت	güç
ضعف	zayıflık
شجاعت	cesaret
ترسویی	korkaklık
صبر	sabr
عجله	acele
آرام	huzur
نگرانی	endişe
شمال	kuzey
جنوب	cenup
شرق	doğu
غرب	garp
بالا	bala
پایین	aşağı
چپ	sol
راست	sağ
داخل	dahil
خارج	dış
جلو	ön
عقب	arka
کنار	Kenar
وسط	orta
اطراف	etraf
فاصله	mesafe
نزدیک	yakın
دور	uzak
سر	baş
صورت	yüz
چشم	göz
بینی	burun
دهان	ağız
دندان	diş
گوش	kulak
گردن	boyun
دست	el
پا	ayak
قلب	kalp
مغز	beyin
خون	kan
استخوان	kemik
پوست	deri
مو	saç
ناخن	tırnak
بیماری	hastalık
درد	ağrı
تب	ateş
سرفه	öksürük
عطسه	hapşırık
قانون	kanun
دادگاه	mahkeme
وکیل	avukat
شاهد	tanık
گواهی	şahitlik
حکم	hakem
مجازات	ceza
زندان	hapishane
آزادی	özgürlük
عدالت	adalet
ظلم	zulüm
حق	hakk
وظیفه	görev
مسئولیت	sorumluluk
تجارت	ticaret
بازرگانی	tüccarlık
سود	kar
زیان	zarar
قیمت	fiyat
ارزش	değer
پرداخت	ödeme
وام	borç
بدهی	borç
دارایی	varlık
مالکیت	mülkiyet
خرید	satın alma
فروش	satış
معامله	işlem
قرارداد	sözleşme
دانشگاه	üniversite
کلاس	sınıf
درس	ders
امتحان	sınav
نمره	not
تدریس	öğretim
تحقیق	araştırma
فناوری	teknoloji
اختراع	icat
کشف	Keşif
نظریه	teori
فرضیه	hipotez
ورزش	spor
فوتبال	futbol
کشتی	güreş
شنا	yüzme
مسابقه	yarışma
برنده	kazanan
بازنده	kaybeden
رقص	dans
سینما	sinema
تئاتر	tiyatro
کنسرت	konser
جشن	parti
دیوان	divan
یَپَجاقلَر	yapacaklar
مشاور	müşavir
مستشار	müsteşar
خطیب	hatip
مؤذن	müezzin
قاری	kari
حافظ	hafız
کاتب	katip
محاسب	muhasebeci
صندوقچی	sandıkçı
میرآخور	mirahor
جاوش	çavuş
سلحدار	silahdar
قاپیجی	kapıcı
آبادی	abadi
آباجور	abajur
آبای	abay
آبازه	abaza
آبیده	abide
آبیده‌وی	abidevi
آبونه	abone
آبراکادابرا	abrakadabra
آبورجوبر	aburcubur
آجابا	acaba
آجمی	acemi
آجملک	acemilik
آجله	acele
آجنت	acente
آجی	acı
آجی‌گول	acıgöl
آجیکلی	acıklı
آجیمسز	acımasız
آجیمتراک	acımtırak
آجی‌ورمک	acıvermek
آجیز	aciz
آد	ad
آداب	adab
آداک	adak
آدام	adam
آدامجا	adamca
آداماک	adamak
آداملک	adamlık
آداوهت	adavet
آدای	aday
آدایلک	adaylık
آدکوات	adekvat
آدم	adem
آدیل	adil
آدلیه	adliye
آدسز	adsız
آدورمک	advermek
آف	af
آفاکی	afaki
آفازی	afazi
آفته‌زده	afetzede
آفته‌مک	affetmek
آففولا	affola
آفیف	afif
آفییت	afiyet
آفوروز	aforoz
آفسون	afsun
آفشار	afşar
آغاج	ağaç
آغا‌بی	ağabey
آغارماک	ağarmak
آغدا	ağda
آغیل	ağıl
آغیت	ağıt
آغیز	ağız
آغلاماک	ağlamak
آغری	ağrı
آغوستوس	ağustos
آه	ah
آهالی	ahali
آهباب	ahbap
آخره	ahiret
آخلاق	ahlak
آخلاقسز	ahlaksız
آهماک	ahmak
آهشاب	ahşap
آیله	aile
آیله‌وی	ailevi
آیت	ait
آک	ak
آکابه	akabe
آکادمی	akademi
آکایت	akait
آکارت	akaret
آکارلار	akarlar
آکارسو	akarsu
آکاریاکیت	akaryakıt
آکچا‌آغاج	akçaağaç
آکینتی	akıntı
آکیپ	akip
آکیبت	akıbet
آکورت	akort
آکران	akran
آکرب	akrep
آکساک	aksak
آکسام	aksam
آکشام	akşam
کاباک	Kabak
کاباهت	kabahat
کاباهتلی	kabahatli
کاباکچی	kabakçı
کاباکلک	kabaklık
کاباکچیلک	kabakçılık
کابالک	kabalık
کاباران	Kabaran
کابارماک	Kabarmak
کابارک	kabarık
کابارتماک	Kabartmak
کابارتمه	Kabartma
کابارش	kabarış
کابینه	Kabine
کابیر	Kabir
کابیرلک	kabirlik
کابریستان	Kabristan
کابلوسز	kablosuz
کابوک	Kabuk
کابوکلو	kabuklu
کابولنماک	kabullenmak
کابوک‌لاشماک	Kabuklaşmak
کابورغا	Kaburga
کابورغالک	kaburgalık
کابوس	Kabus
کابول	Kabul
کابول‌اتماک	Kabul etmek
کابیل	Kabil
کابوتاج	Kabotaj
کاداسترو	Kadastro
کادمه	Kademe
کادمه‌لی	Kademeli
کادیفه	Kadife
کادیم	Kadim
کادی	Kadı
کادی‌عسکر	Kadıasker
کادیلک	kadılık
کادین	Kadın
کادینجا	kadınca
کادینلک	kadınlık
کادینسی	kadınsı
کادرو	Kadro
کافه	Kafe
کافیتاریه	kafeterya
کافی	Kafi
کافییه	kafiye
کافیل	kafile
کاه‌رمان	kahraman
کاه‌والتی	Kahvaltı
کاهیا	kahya
کاه‌وه‌خانه	Kahvehane
کاه‌ورنگی	Kahverengi
کاه‌رولماک	Kahrolmak
کالافات	Kalafat
کالاک	Kalak
کالاکماک	kalakmak
کالاکلامه	kalaklama
کالاکلی	kalaklı
کالاکلک	kalaklık
کالاماک	Kalamak
کالانک	Kalank
کاله	Kale
کالم	Kalem
کالمی	Kalemi
کالملک	kalemlik
کالسی	kalesi
کالچی	kalıcı
کالکماک	kalkmak
کالکش	kalkış
کالکشماک	kalkışmak
کالکشمه	kalkışma
کالکنماک	kalkınmak
کالکنمه	kalkınma
کالکان	Kalkan
کالکانماک	kalkanmak
کالکر	Kalker
کاللاوی	Kallavi
کالماک	kalmak
کالپ	Kalp
کالپاک	Kalpak
کالپغی	kalpağı
کالپاکچی	kalpakçı
کالپاچ	Kalpaç
کالیا	Kalya
کالیون	Kalyon
کامار	Kamar
کامره	Kamera
کامره‌مان	Kameraman
کامپ	Kamp
کامپانیه	kampanya
کامیون	Kamyon
کامیونت	kamyonet
کان	Kan
کانال	Kanal
کانالیزاسیون	Kanalizasyon
فابریکه	fabrika
فاجعه	faciâ
فاجعه‌کار	faciâkâr
فادی	fadî
فخری	fahri
فخریه	fahriye
فقیره	fakire
فقیرلک	fakirlik
فاکولته	fakülte
فالا	fala
فالان	falan
فالانجانین	falancanın
فالاک	falak
فالاک‌ی‌شریف	falak-ı şerîf
فالاکه	falaka
فالچی	falçı
فارس	fars
فارسچه	farsça
فصل	fasl
فصیح	fasih
فاسیل	fasil
فاست‌فود	fastfood
فاتوره	fatura
فایدا	fayda
فایدالانماک	faydalanmak
فایدالی	faydalı
فایدا‌ساعلاماک	fayda sağlamak
فایتون	fayton
فاز	faz
فاضله	fazla
فاضلالک	fazlalık
فاضلی	fazlı
فاضلیلک	fazlılık
فدا	feda
فداکارلک	fedakârlık
فداکار	fedakâr
فدرال	federal
فجر	fecr
فجر‌ی‌صادق	fecr-i sadık
فدراسیون	federasyon
فهیم	fehim
فهیملی	fehimli
فئودال	feodal
فراجه	ferace
فراعت	feragat
فراه	ferah
فراهلاتماک	ferahlatmak
فراهلاماک	ferahlamak
فراهلک	ferahlik
فراست	feraset
فرهاد	ferhâd
فری	feri
فری‌بوت	feribot
فریک	ferik
فرمت	fermet
فرموار	fermuar
فرزنده	ferzende
فوق‌العاده	fevkalâde
فوری	fevri
فوریت	fevriyet
فوزی	fevzî
فوزیات	fevzîyat
فضا	feza
فضله	fezleke
فضله‌جی	fezlekeci
فیات	fiat
فیبریلاسیون	fibrilasyon
فیبروما	fibroma
فدیه	fidye
فیدان	fidân
فکری	fikri
فکرت	fikret
فکریات	fikriyat
فیل	fil
فلیسطین	filistin
فیلولوجیک	filolojik
فیلسوف	filozof
فیلسوفیک	filozofik
فیلتر	filtre
فیلیاسیون	filyasyon
فینال	final
فینانس	finans
فینگیردک	fingirdek
فیرمه	firma
محجوبیت	mahcubiyet
ماهیاتسزلک	mahiyetsizlik
محرومیت	mahrumiyet
مقصاتلک	maksatlılık
معقولیت	makuliyet
معقولجه	makulce
معلوماتلی	malumatlı
معلوماتچیلک	malumatçılık
معلوماتسزلک	malumatsızlık
معولن	malulen
معولیت	maluliyet
مامافیه	mamafih
مامولیت	mamuliyet
معناسزلک	manasızlık
معنویاتچیلک	maneviyatçılık
معنویلشترماک	manevileştirmek
معنویلشترابیلماک	manevileştirebilmek
معنویاتسزلاشماک	maneviyatsızlaşmak
معنویاتسزلک	maneviyatsızlık
مراضلک	marazilik
مرانگوزلک	marangozluk
مارجیناللشماک	marjinalleşmek
مارجیناللشترماک	marjinalleştirmek
مسکارالاشماک	maskaralaşmak
مصرفسزلک	masrafsızlık
معصومیت	masumiyet
معصوملاشترماک	masumlaştırmak
ماتماتیکلشماک	matematikleşmek
ماتماتیک‌سل	matematiksel
ماتلاشماک	matlaşmak
ماتلاشترماک	matlaştırmak
مضبوطلک	mazbutluk
مظوریت	mazuriyet
مظورسز	mazursuz
مجل‌سزلک	mecalsizlik
مجبوریت	mecburiyet
مجبورلاشترماک	mecburlaştırmak
مجنونلاشماک	mecnunlaşmak
مدیاتیکلشماک	medyatikleşmek
مدیاسزلک	medyasızlık
مفتونیت	meftuniyet
مگرسه	meğerse
مهبتلی	mehabetli
مهترلشماک	mehterleşmek
مکان‌ساللک	mekânsallık
مکان‌سزلک	mekânsızlık
مکتبلی	mektepli
مکتبسزلک	mektepsizlik
مکروهلاشماک	mekruhlaşmak
ملانکولیکلک	melankoliklik
ملانکولیه	melankoliye
ملودراماتیک	melodramatik
مملکتللیک	memleketlilik
مملکتلشماک	memleketleşmek
ممنونیت	memnuniyet
ممنونیتسزلک	memnuniyetsizlik
مأموریت	memuriyet
منفعتسزلک	menfaatsizlik
منفی	menfi
منفور	menfur
منشئینه	menşeine
منسوبیت	mensubiyet
منسوبسزلک	mensupsuzluk
منتورلک	mentorluk
منزلسزلک	menzilsizlik
مراکلاندرماک	meraklandırmak
مراکلیجه	meraklıca
مربوطیت	merbutiyet
مردانلک	merdanelik
مرحمتسزجه	merhametsizce
مرحمتسزلک	merhametsizlik
مرکبجه	merkepçe
مرکزیلشماک	merkezileşmek
مرکزیلشترماک	merkezileştirmek
مرکزسزلک	merkezsizlik
مصاعیه	mesaiye
مصاعی‌خارجی	mesaiharici
مسئله‌لشماک	meseleleşmek
مسئله‌سزلک	meselesizlik
مشلکیت	meslekiyet
مشلکسزلک	mesleksizlik
مسنتسزلک	mesnetsizlik
مسروریت	mesruriyet
مسؤولیت	mesuliyet
مسؤولیتسزلک	mesuliyetsizlik
میتافورموز	metaformoz
میتالاشماک	metalaşmak
میتالیزه	metalize
میتامورفوز	metamorfoz
میتازوری	metazori
میتینلک	metinlik
میتودولوجیک	metodolojik
میتودولوجیکلشماک	metodolojikleşmek
صداقت	sadakat
صفیت	safiyet
صدقه	sadaka
سادت	sadet
صادق	sadık
سادت‌نامه	sadetname
صدر	sadr
صفا	safa
صفحه	safha
صف‌کان	safkan
سفسطه	safsata
صاف	saf
صحابه	sahabe
صحاف	sahaf
سحان	sahan
صحیح	sahih
صاحب	sahip
صحنه	sahne
صحن	sahn
سایر	sair
سقال	sakal
سکت	sakıt
سکتات	sakatat
سکیل	sakil
سکینمه	sakınma
سکلی	saklı
سکینجه	sakınca
سکینتی	sakıntı
سلا	sala
صلوات	salavat
صلاحیت	salahiyet
صالح	salih
سلیک	salik
سلیم	salim
سلیسه	salise
ساللانتی	sallantı
سالیانگوز	salyangoz
سالون	salon
سلطنت	saltanat
سالو	salvo
صمیمی	samimi
صمیمیت	samimiyet
سامسونلو	samsunlu
صنایع	sanayi
صنعت	sanat
صنعت‌کار	sanatkâr
سنری	sanrı
سنزور	sansür
سنتیم	santim
سرای	saray
صرف	sarf
سرهوش	sarhoş
سارکینتی	sarkıntı
سارکی	sarkı
سارکمه	sarkma
صراف	sarraf
سارساک	sarsak
سارسینتی	sarsıntı
سارسماک	sarsmak
سارت	sart
ساریک	sarık
ساری‌کامش	sarıkamış
سارمه	sarma
سارمال	sarmal
صرافییه	sarrafiye
سارسلماک	sarsılmak
سطح	satıh
سطر	satır
ساتماک	satmak
ساتین	satın
ساتجی	satıcı
ساو	sav
ساواش	savaş
ساواشجی	savaşçı
ساوجی	savcı
ساولت	savlet
ساوران	savran
ساو‌ساکلامه	savsaklama
سایفه	sayfa
سایغی	saygı
سایغیلی	saygılı
سایها	sayha
سایی	sayı
سایی‌سال	sayısal
سایقال	saykal
سایماک	saymak
سایمان	sayman
ساز	saz
ثبات	sebat
سبب‌سز	sebepsiz
سبب	sebep
تقوی	takva
طهارت	taharet
تحقیقات	tahkikat
تحصیل	tahsil
تقدیم	takdim
تقدیر	takdir
تتبع	takip
تقسیم	taksim
تقسیرات	taksirat
طالبه	talebe
طلب	talep
تلفیف	taltif
تنظیم	tanzim
تعظیم	tazim
تضمینات	tazminat
تبلیغ	tebliğ
تجوید	tecvid
تفسیر	tefsir
تفکر	tefekkür
تهدید	tehdit
تهلکه	tehlike
تکبیر	tekbir
تکیه	tekke
تکمیل	tekmil
تکذیب	tekzip
تلقی	telakki
تمایل	temayül
تمیزلک	temizlik
تمکین	temkin
تمثیل	temsil
تنسیپ	tensip
تپه	tepe
تربیه	terbiye
ترجیح	tercih
تردد	tereddüt
ترفی	terfi
ترخیس	terhis
ترک	terk
ترتیب	tertip
تسبیح	tespih
تسلی	teselli
تستر	tesettür
تأثیر	tesir
تسلیم	teslim
تسلیمیت	teslimiyet
تستی	testi
تشبیه	teşbih
تشکر	teşekkür
تشکیل	teşkil
تشکیلات	teşkilat
تشریفات	teşrifat
تشریح	teşrih
تشویق	teşvik
تواضع	tevazu
توجه	teveccüh
توفیق	tevfik
توحید	tevhid
توحیدی	tevhidi
توحید‌سل	tevhidsel
تأویل	tevil
توقیف	tevkif
توقیفات	tevkifat
تورات	tevrat
توریه	tevriye
توسی	tevsi
توزیع	tevzi
تظاهر	tezahür
تضاد	tezat
تزکیه	tezkiye
تزویر	tezvir
طب‌بیه‌لی	tıbbiyeli
طفیل	tıfıl
تیکاچ	tıkaç
طلسم	tılsım
تیمار	tımar
تیمارخانه	tımarhane
تیپ‌قی‌باسم	tıpkıbasım
تراش	tıraş
ترناق	tırnak
طینت	tıynet
تیغ	tığ
تاباق	tabak
تابان	taban
طبیعت	tabiat
طبیبه	tabibe
طبیب	tabip
تابلاجی	tablacı
تابلو	tablo
تابوت	tabut
تعدیل	tadil
تعدیلات	tadilat
تفصیلات	tafsilat
تغییر	tağyir
تحاجد	tahaccüd
تحقق	tahakkuk
تحمل	tahammül
طهارت‌لنماک	taharetlenmek
تحکیم	tahkim
یادگار	yâdigâr
یارن	yâren
یار	yar
یقین	yakîn
یقینلک	yakınlık
یابانجی	yabancı
یاقازه	yakaza
یاقوت	yakut
یالنیزلک	yalnızlık
یامالی	yamalı
یامچیلی	yamçılı
یاناشمه	yanaşma
یانگین	yangın
یانسیمه	yansıma
یانیک	yanık
یاراتجی	yaratıcı
یاراتیلش	yaratılış
یاردم	yardım
یاردمجی	yardımcı
یاردم‌سور	yardımsever
یاری	yarı
یارین	yarın
یارینکی	yarınki
یاریش	yarış
یاریشمه	yarışma
یاسا	yasa
یاساک	yasak
یاساکلی	yasaklı
یاسال	yasal
یاسمین	yasemin
یاسین	yasin
یاسلانماک	yaslanmak
یاسلی	yaslı
یاسی	yassı
یاش	yaş
یاشام	yaşam
یاشاماک	yaşamak
یاشانمشلک	yaşanmışlık
یاشانتی	yaşantı
یاشار	yaşar
یاشلی	yaşlı
یات	yat
یاتیریم	yatırım
یاتیرمجی	yatırımcı
یاتکین	yatkın
یاتماک	yatmak
یاتسی	yatsı
یاور	yaver
یاووز	yavuz
یاز	yaz
یازغی	yazgı
یازی	yazı
یازجی	yazıcı
یازلی	yazılı
یازیم	yazım
یازماک	yazmak
یازمالی	yazmalı
یازمه	yazma
یای	yay
یایگین	yaygın
یاییلمه	yayılma
یایله	yayla
یایماجی	yaymacı
یایماک	yaymak
یایوان	yayvan
یازغیلی	yazgılı
یاغ	yağ
یاغجی	yağcı
یاغلی	yağlı
یاغماک	yağmak
یاغمور	yağmur
یاغمورلک	yağmurluk
یاغسز	yağsız
یاغیز	yağız
یاشامی	yaşamı
یاشایان	yaşayan
یاشاتماک	yaşatmak
یاشلک	yaşlık
یاشیت	yaşıt
یاشلیلک	yaşlılık
یاشماک	yaşmak
یاکارمه	yakarma
یاکجی	yakıcı
یاکلاشیم	yaklaşım
یاکماک	yakmak
یاکوپ	yakup
یاقوتی	yakutî
یقینی	yakînî
یقینات	yakînât
یاکتی	yaktı
یاکلاشترجی	yaklaştırıcı
یاکلاشترمه	yaklaştırma
یقینلاشمه	yakınlaşma
یاکاران	yakaran
یاکارش	yakarış
یالاپ‌شاپ	yalapşap
یالین	yalın
ضابطه	zabıta
ضعفیت	zafiyet
ظفر	zafer
زاهده	zahide
زحمت	zahmet
زحمتسز	zahmetsiz
ظاهر	zahir
زاهت	zahit
ظالم	zâlim
زمان	zaman
زمانه	zamane
ضمیر	zamir
زمک	zamk
ضم	zamm
ظرف	zarf
ظرفیت	zarfiyet
ظریف	zarif
ظرافت	zarafet
ضرورت	zaruret
ضروری	zarûrî
ضرر	zarar
ضررلی	zararlı
ضعفلک	zayıflık
زبانی	zebanî
زجر	zecr
زبون	zebun
زده‌لنماک	zedelenmek
ذکا	zeka
زکات	zekât
ذکی	zeki
ذکاوت	zekâvet
ذلیل	zelil
زمحشری	zemahşerî
زمزم	zemzem
زنگین	zengin
زنگینلک	zenginlik
زنّی	zennî
زنه	zenne
زوال	zeval
زوجه	zevce
زوجات	zevcat
ذوق	zevk
ذوقیات	zevkiyat
ذوقی	zevkî
ذوقسز	zevksiz
ذوات	zevat
زهر	zehîr
زهرلنماک	zehirlenmek
زهرسز	zehirsiz
زهرلی	zehirli
زهرجیلک	zehircilik
زبونلک	zebunluk
زبانیت	zebaniyet
زبانیلک	zebanîlik
زبانلک	zebanlık
زبلله	zebella
زده‌لنه	zedelenme
زده‌سز	zedesiz
زده‌سزلک	zedesizlik
زکاتلک	zekatlık
زکریا	zekeriya
ذکر	zikra
ذکر‌اتماک	zikretmek
ذکرالله	zikrullah
ذکر‌ذاک	zikzak
ذکره	zikra
ضدییت	zıddiyet
ضدی	zıddî
ضکیم	zıkkım
ضکیملانماک	zıkkımlanmak
ضپلایش	zıplayış
ضپلاماک	zıplamak
ضره	zırh
ضره‌لی	zırhlı
ضت	zıt
ضتلک	zıtlık
ضوانادان	zıvanadan
ضوانادان‌چیقماک	zıvanadan çıkmak
ضبین	zıbın
ضنا	zina
ضنهار	zinhar
ضیرا	zira
ضیراعت	zirâat
ضیراعتچی	zirâatçi
ضروه	zirve
زیاده	ziyade
زیاده‌سیله	ziyadesiyle
ضیافت	ziyafet
ضیاکار	ziyakar
ضیا	ziya
ضیارت	ziyaret
بابا	baba
باباجان	babacan
بابالک	babalık
باجا	baca
باجی	bacı
باده	bade
بادهره	badire
بافرا	bafra
بهانه	bahane
بهار	bahar
بهارات	baharat
بهاریه	bahariye
بهچهلک	bahçelik
بهچیوان	bahçıvan
بهیر	bahir
بهیس	bahis
بهیه	bahiye
بحر	bahr
بحریه	bahriye
بهس‌اتماک	bahsetmek
بهسی	bahsi
بهت	baht
بهتیار	bahtiyar
باکیم	bakım
باکیملی	bakımlı
باکیمجی	bakımcı
باکینماک	bakınmak
باکیش	bakış
باکیشماک	bakışmak
باکلا	bakla
باکلاوا	baklava
باکماک	bakmak
باکسی	baksı
باکتری	bakteri
بال	bal
بالابان	balaban
بالاد	balad
بالالایکا	balalayka
بالجی	balcı
بالچیق	balçık
بالدیر	baldır
بالدیز	baldız
بالت	balet
بالغام	balgam
بایق	balık
بایقچی	balıkçı
بایقچیلک	balıkçılık
بالینا	balina
بالکون	balkon
باللی	ballı
بالون	balon
بالسام	balsam
بالتاجی	baltacı
بالتا	balta
بالیمز	balyemez
بامبو	bambu
بانا	bana
بانال	banal
بانداج	bandaj
باندو	bando
باندروال	bandrol
بانماک	banmak
بانت	bant
بانیو	banyo
بابتیست	baptist
بار	bar
باراج	baraj
باراکا	baraka
باربار	barbar
باربارلک	barbarlık
باربک	بarbekü
باربوت	barbut
باریش	barış
باریشماک	barışmak
بارییر	bariyer
باریز	bariz
بارکود	barkod
باروک	barok
بارون	baron
باروت	barut
باساماک	basamak
باسار	basar
بصیرت	basiret
باسین	basın
باسینج	basınç
بصیرتلی	basiretli
باسیت	basit
باسقی	baskı
باسکین	baskın
باسماک	basmak
باستیرماک	bastırmak
باستون	baston
باسور	basur
باش	baş
باشاک	başak
باشارلی	başarılı
باشاری	başarı
باشارماک	başarmak
جابا	caba
جبار	cabbar
جاهل	cahil
جاهلیه	cahiliye
جاکا	caka
جاکا‌ساتماک	caka satmak
جاکالی	cakalı
جالپ	calip
جام	cam
جامجی	camcı
جامع	cami
جامی	camii
جامیش	camış
جامیز	camız
جان	can
جانا‌یاقین	cana yakın
جانان	canan
جانی	cani
جانلی	canlı
جانلیلک	canlılık
جانیم	canım
جانینا‌سوساماک	canına susamak
جانپ	canip
جاریه	cariye
جاریه‌اتماک	cariye etmek
جرزی‌هارچ	carzıharç
جازه	caza
جفا	cefa
جهالت	cehâlet
جهنم	cehennem
جکت	ceket
جلادت	celâdet
جلال	celal
جلالی	celalî
جلب	celb
جلب‌اتماک	celbetmek
جلیل	celil
جم	cem
جماعت	cemaat
جمال	cemal
جمیعت	cemiyet
جمره	cemre
جنازه‌لک	cenazelik
جنازه	cenaze
جندره	cendere
جنگ	cenk
جنت	cennet
جیب	cep
جبهه	cephe
جربزه	cerbeze
جسارت	cesaret
جسیم	cisim
جسور	cesur
جت	Jet
جواب	cevap
جوابسز	cevapsız
جواز	cevaz
جوهر	cevher
جویک	cevik
جیلان	ceylan
جزا	cezâ
جزالاندیرماک	cezalandırmak
جزب‌دجی	cezbedici
جزب‌اتماک	cezbetmek
جزبولماک	cezbolmak
جیویک	cıvık
جیویل‌جیویل	cıvıl cıvıl
جیاکلاماک	cıyaklamak
جیا	cıya
جییرداماک	cıyırdamak
جیاک	cıyak
جیغارا	cıgara
جیمبیز	cımbız
جیویلداماک	cıvıldamak
جیویلتی	cıvıltı
جیویتماک	cıvıtmak
جزم	cezm
جزری	cezri
جزوه	cezve
جیگر	ciğer
جیگرجی‌باشی	ciğercibaşı
جهان	cihan
جهاد	cihat
جیلا	cila
جلد	cilt
جیم	cim
جیمری	cimri
جن	cin
جنایت	cinayet
جنس	cins
جنسیت	cinsiyet
جوار	civar
جیولک	civelek
جیزره	cizre
جوشکو	coşku
جوشماک	coşmak
جوشکولو	coşkulu
داغ	dağ
داغجی	dağcı
داغیلماک	dağılmak
داغیتماک	dağıtmak
داغینق	dağınık
داغلامه	dağlama
داغلک	dağlık
دها	daha
دایم	dâim
دایره	dâire
دار	dar
دارالتماک	daraltmak
داربه	darbe
دارگین	dargın
دارتماک	dartmak
داورانماک	dâvranmak
داورانش	davranış
داوه	dava
داوالی	davalı
دایاک	dayak
دایانماک	dayanmak
دایانشما	dayanışma
دایاتما	dayatma
دگر	değer
دگرسز	değersiz
دگیشیم	değişim
دگیشیکلک	değişiklik
دگیشماک	değişmek
دهشت	dehşet
دلی‌کانلی	delikanlı
دلی	deli
دماک	demek
دمیر	demir
دملماک	demlemek
دمکراسی	demokrasi
دمکرات	demokrat
دنی	deney
دنییم	deneyim
دنیز	deniz
دنیزجیلک	denizcilik
دستک	destek
دستکلماک	desteklemek
دستورسز	destursuz
دتای	detay
دوام	devam
دواملی	devamlı
دویرماک	devirmek
دولت	devlet
دوره	devre
دوراتماک	devretmek
دوریم	devrim
دوشیرماک	devşirmek
دعوت	dâvet
داورانش‌سال	dâvranışsal
دعوا	dâvâ
دعواجی	dâvacı
دعوالی	dâvâlı
دایانقلی	dayanıklı
دایاتماک	dayatmak
دگرلندیرماک	değerlendirmek
دلالت	delalet
دمت	demet
دملنماک	demlenmek
دنتیم	denetim
دنتلماک	denetlemek
دنیزجی	denizci
دنیز‌قیزی	denizkızı
دنت	dente
درنک	dernek
درت	dert
دستکسز	desteksiz
دوزلتماک	düzeltmek
دوزن	düzen
دوزنلماک	düzenlemek
دوشونماک	düşünmek
دوشونجه	düşünce
دوشون‌سل	düşünsel
دوزنلی	düzenli
دوشماک	düşmek
دوشونجلی	düşünceli
دوشونور	düşünür
دونیا	dünya
دونیوی	dünyevi
دوز	düz
دوزی	düzey
دوزلتمه	düzeltme
دوگون	düğün
دوگوم	düğüm
دونور	dünür
دودوک	düdük
دونورلک	dünürlük
دایمی	daimi
دامغا	damga
داملا	damla
داملاتماک	damlatmak
دانیشماک	danışmak
ابه	ebe
ابدی	ebedi
ابرو	ebru
اجل	ecel
ادب	edeb
ادبیات	edebiyat
ادبلی	edepli
ادیلماک	edilmek
افندی	efendi
افور	efor
افسانه	efsane
اگمن	egemen
اگمنلک	egemenlik
اهلیت	ehliyet
اکیپ	ekip
اکلماک	eklemek
اکونومی	ekonomi
اکوسیستم	ekosistem
اکسیک	eksik
اکسیکلک	eksiklik
اکسن	eksen
اکسپرس	ekspres
اکسترا	ekstra
ال	el
الچی	elçi
الستیرماک	eleştirmek
الستیری	eleştiri
الکتریک	elektrik
الکترونیک	elektronik
البسه	elbise
الما	elma
امک	emek
امکچی	emekçi
املاک	emlak
امنییت	emniyet
امپریال	emperyal
امپریالیزم	emperyalizm
امپاتی	empati
امثال	emsal
امزیرمه	emzirme
ان	en
انفلاسیون	enflasyon
انگلماک	engellemek
انگیزاسیون	engizisyon
انیک	enik
انکاز	enkaz
انلم	enlem
انستیتو	enstitü
انتگر	entegre
انتلکتوئل	entellektüel
انتگراسیون	entegrasyon
اپیدمیک	epidemik
اپیک	epik
اپیکریز	epikriz
اپیستیمولوژی	epistemoloji
اپیستیمولوژیک	epistemolojik
ارکک	erkek
ارکن	erken
ارکنجه	erkence
ارکم	erkem
ارکملک	erkemlik
ارککلک	erkeklik
ارزاق	erzak
اسارت	esaret
اثر	eser
اثرلماک	eserlemek
اثرلک	eserlik
اشک	eşek
اشیک	eşik
اشیت	eşit
اشیتلک	eşitlik
اسکی	eski
اسکیا	eskiyâ
اسکیز	eskiz
اسمر	esmer
اسپری	espri
اسرار	esrar
اسرار‌انگیز	esrarengiz
اسرین	esrin
اسواب	esvap
اسوابلک	esvaplık
ات	et
اتاپ	etap
اتکین	etkin
اتکیلماک	etkilemek
اتکینلک	etkinlik
اتکیلشیم	etkileşim
اتکی	etki
اتماک	etmek
اتود	etüt
اوجل	evcil
اوده	evde
اولیلک	evlilik
اوراق	evrak
اورن‌سل	evrensel
اوریم	evrim
گاباری	gabari
گاده	gada
گدا	gadâ
غدر	gadir
غدری	gadri
غفلت	gaflet
غافل	gafil
غافلانه	gafilane
غافلجه	gafilce
غفلتلی	gafletli
غافل‌زاده	gafilzâde
گاگ	gag
گاگا	gaga
گاه	gah
گاهی	gahi
غای	gai
غایل	gail
غایطه	gaita
گاک	gak
غلبه	galebe
غالب	galip
گالوش	galoş
گالوانیز	galvaniz
گامل	gamel
گامی	gami
گانه	gana
گندا	gandâ
غنیمت	ganimet
غرابت	garabet
غرز	garaz
غرزکار	garazkâr
غرزلی	garazlı
گاردیان	gardiyan
غرغره	gargara
غریب	garip
غریبلک	gariplik
گارنیزون	garnizon
غصب	gasp
غصبچی	gaspçı
غسال	gassâl
گاور	gavur
گاورخانه	gâvurhâne
غاز	gazi
گازته	gazete
گازیلک	gazilik
گازوز	gazoz
گازوزجو	gazozcu
غضب	gazap
غضب‌لانماک	gazaplanmak
گازته‌جی	gazeteci
گازته‌چیلک	gazeteçilik
غیب	gayb
غیرت	gayret
غیرتلی	gayretli
غیر‌منقول	gayrimenkul
غیر‌مشروع	gayr-ı meşru
غیر‌رسمی	gayr-ı resmi
غیر‌صافی	gayr-ı safi
غیر‌صیح	gayr-ı sahih
گازینو	gazino
گبه‌لک	gebelik
گدیک	gedik
گچیت	geçit
گچکین	geçkin
گچماک	geçmek
گجنین	gecenin
گجیکماک	gecikmek
گجیکمه	gecikme
گله‌جک	gelecek
گلماک	gelmek
گمی	gemi
گمیجی	gemici
گنج	genç
گنجلک	gençlik
گنیش	geniş
گنیشلک	genişlik
گنیشلتمک	genişletmek
گنیشلمه	genişleme
گنتیک	genetik
گرچک	gerçek
گرچکچی	gerçekçi
گرگین	gergin
گری	geri
گریلماک	gerilemek
گریلیم	gerilim
گرماک	germek
گرچکلشماک	gerçekleşmek
گریه	geriye
گری‌زکالی	gerizekalı
گس	ges
گتیرماک	getirmek
حبه	habbe
حبس	habes
خبیث	habis
حبیطات	habitat
حبیبه	habibe
حج	hac
حجامت	hacamat
حاجل	hacıl
حاجیلک	hacılık
حجم	hacim
حجز	haciz
حجز‌ادیلماک	haczedilmek
حد	hadd
حده	hadde
حده‌خانه	haddehane
خدمه	hademe
خادم	hadim
حدسز	hadsiz
هفته‌لک	haftalık
هفته‌لکچی	haftalıkçı
خف	hafif
خف‌لتمک	hafifletmek
حفریات	hafriyat
حافظلک	hafızlık
حادثه	hâdise
حکاک	hakkâk
حکانییت	hakkaniyet
حقی	hakkı
حقلی	haklı
حاکم	hakim
حاکمیت	hakimiyet
حقیقت	hakikat
حقیقتلی	hakikatli
حقیر	hakir
حقیر‌گورمک	hakir görmek
حقلیلک	haklılık
حک‌نامه	hakname
حکارت	hakaret
حال	hal
هله	hala
حبل	halat
هلای	halay
خلیف	halef
حالت	halet
خالص	halis
حلقه	halka
حلقه‌آچیق	halka açık
حلقه‌ارز	halka arz
خلق	halk
خلقلا‌ایلیشکیلر	halkla ilişkiler
هلوک	haluk
خلوت	halvet
حمال	hamal
حمارت	hamarat
حامله	hamile
حمیت	hamiyet
حمیتلی	hamiyetli
خمیر	hamur
خمیر‌ایشی	hamur işi
خاندان	hanedan
خانم	hanım
خانم‌افندی	hanımefendi
خانلک	hanlık
خانس	hans
خانوت	hanut
خرابه	harabe
حرکت	haraket
حرارت	hararet
حربی	harbi
هرچ	harç
حرف	harf
حرفیات	harfiyat
حری‌قوالاده	harikulade
حریطه	harita
هرمان	harman
هرمان‌یوری	harman yeri
حرب	harp
حرب‌صناعی	harp sanayi
حرب‌اوینلری	harp oyunları
هرشی	harşı
هرت	hart
هرچلک	harçlık
خاص	has
خسار	hasar
حصاد	hasat
حسب‌حال	hasbihal
حسنه	hasene
خصم	hasım
خصلت	haslet
حسرت	hasret
حسه	hasse
خسته	hasta
اداره	ıdare
اداری	ıdari
اداره‌جی	ıdareci
اداره‌اتماک	ıdare etmek
اداره‌لی	ıdareli
ادراک	ıdrak
اهلامور	ıhlamur
ایقینماک	ıkınmak
ایقینمه	ıkınma
ایلیق	ılık
ایلیق‌سو	ılık su
ایلیق‌هاوا	ılık hava
ایلیق‌یور	ılık yer
ایلیق‌لاشماک	ılıklaşmak
ایلیق‌لاشترماک	ılıklaştırmak
ایلیجه	ılıca
ایلیجه‌سوی	ılıca suyu
اصلاح	ıslah
اصلاح‌اتماک	ıslah etmek
اصلاح‌خانه	ıslahhane
ایسلاک	ıslak
ایسلاکلک	ıslaklık
اصرار	ısrar
اصرار‌اتماک	ısrar etmek
اصرارجی	ısrarci
ایسسز	ıssız
ایسسزلک	ıssızlık
ایشیق	ışık
ایشیق‌لاندیرماک	ışıklandırmak
ایشیقلی	ışıklı
ایشین	ışın
ایشین‌لاماک	ışınlamak
ایشین‌لانماک	ışınlanmak
اصلاحاتچی	ıslahatçı
اصلاحات‌یاپماک	ıslahat yapmak
اصلاحات‌حرکت	ıslahat hareketi
ایسلاک‌زمین	ıslak zemin
ایشکین	ışkın
ایشکینلک	ışkınlık
ایرمک	ırmak
ایرمک‌بوی	ırmak boyu
ایرمکلک	ırmaklık
ایرغات	ırgat
ایرغاتلک	ırgatlık
ایرک	ırk
ایرکچی	ırkçı
ایرمک‌کناری	ırmak kenarı
ایراق	ırak
ایراق‌لاشماک	ıraklaşmak
ایراق‌لاشترماک	ıraklaştırmak
ایراقلی	ıraklı
ایراقلیلار	ıraklılar
ایراق‌دوغو	ırak doğu
ایراق‌باتی	ırak batı
ایراق‌کوزی	ırak kuzey
ایراق‌گونی	ırak güney
ایرمک‌قییسی	ırmak kıyısı
ایرمک‌چوروسی	ırmak çevresi
ایرمک‌یاتغی	ırmak yatağı
اضطراب	ızdırap
اضطرابلی	ızdıraplı
اضاحته	ızahta
اضاحته‌بولونماک	ızahta bulunmak
اضرار	ızdırar
اضرار‌اتماک	ızdırar etmek
اصلاحچی‌اولماک	ıslahçı olmak
اصرارلا	ısrarla
ایسسز‌آدا	ıssız ada
ایسسز‌یور	ıssız yer
ایسسز‌لاشماک	ıssızlaşmak
ایسسز‌لاشترماک	ıssızlaştırmak
ایشیق‌حیزی	ışık hızı
ایسرارلی	ısrarlı
ایسرارلی‌اولماک	ısrarlı olmak
ایسرارلی‌داوارانماک	ısrarlı davranmak
ایراقلیق	ıraklık
ایرمک‌دلتاسی	ırmak deltası
ایرمک‌حوضاسی	ırmak havzası
ایرمک‌آغزی	ırmak ağzı
ایرکچیلیک	ırkçılık
ایاده	İade
ایبارت	İbaret
ابراهیم	İbrahim
ایجات	İcat
ایچریک	İçerik
ایچگودی	İçgüdü
ایچکی	İçki
ایچسل	İçsel
ایچتن	İçten
ایدعیا	İddia
ایدیال	İdeal
ایدراک	İdrak
ایفاده	İfade
ایفشا	İfşa
ایخبار	İhbar
ایهمال	İhmal
ایخراج	İhraç
ایحسان	İhsan
ایحتیاج	İhtiyaç
ایکامه	İkame
ایکامت	İkamet
ایکاروس	İkarus
ایکبال	İkbal
ایکینجیل	İkincil
ایکیز	İkiz
ایکلیم	İklim
ایکون	İkon
ایکتیدار	İktidar
ایکرام	İkram
ایکرار	İkrar
ایکراز	İkraz
ایکسپ	İkseb
ایکسیر	İksir
ایقتصاد	İktisat
ایلاهی	İlahi
ایلاهیات	İlahiyat
ایلاوه	İlave
ایلچه	İlçe
ایلگی	İlgi
ایلگینچ	İlginç
ایلک‌باهار	İlkbahar
ایلکلی	İlkeli
ایلک‌اوکول	İlkokul
ایلییت	İlliyet
ایلمک	İlmek
ایل‌میه	İlmiye
ایلتیفات	İltifat
ایلتیهاب	İltihap
ایلتیماس	İltimas
ایلزام	İlzam
ایمام	İmam
ایمانا	İmana
ایمانت	İmanet
ایمانلی	İmanlı
ایمار	İmar
ایمبات	İmbat
ایمدات	İmdat
ایمگه	İmge
ایمگهلهم	İmgelem
ایمکان	İmkan
ایملهچ	İmleç
ایملا	İmla
ایملهک	İmlek
ایملهکلیک	İmleklik
ایمپراتور	İmparator
ایمپراتورلوک	İmparatorluk
ایمرنمک	İmrenmek
ایمروز	İmroz
ایمساک	İmsak
ایمتیحان	İmtihan
ایمتیاز	İmtiyaz
اینجه	İnce
اینجلتمک	İnceltmek
اینجیتمک	İncitmek
اینجیر	İncir
اینجیزاب	İncizap
اینگه	İnek
اینگفاز	İnfaz
اینگفیلاک	İnfilak
اینگلیز	İngiliz
اینگلیزجه	İngilizce
اینگحیصار	İnhisar
اینگیش	İniş
اینگکار	İnkar
اینگمک	İnmek
اینگشا	İnşa
اینگشاعات	İnşaat
اینگشیراح	İnşirah
اینگتیبا	İntiba
اینگتیحار	İntihar
اینگتیکام	İntikam
اینگتیکال	İntikal
اینگتیساپ	İntisap
اینگتیزام	İntizam
اینگترامولکولر	İntramoleküler
اینگترانت	İntranet
اینگکیشاف	İnkişaf
اینگکیلاب	İnkilap
اینگلم	İnlem
اینگمه	İnme
اینگشاالله	İnşaaallah
اینگشیراح‌لانماک	İnşirahlanmak
اینگشیراح‌لاندیرماک	İnşirahlandırmak
اینگتراکتیف	İnteraktif
اینگترنت	İnternet
اینگوازیون	İnvazyon
اینگویترو	İnvitro
اینگشیراحلی	İnşirahlı
اینگفیلتراسیون	İnfiltrasyon
اینگولوسیون	İnvolüsyon
اینگتورن	İntörn
ایپ	İp
ایپ‌اوچو	İpucu
ایپلیک	İplik
ایپنوتیزما	İpnotizma
ایراده	İrade
ایراده‌لی	İradeli
ایرات	İrat
ایرجاع	İrca
ایری	İri
ایری‌یاری	İriyarı
ایرفان	İrfan
ایریکلمک	İrkilmek
ایریتاسیون	İritasyon
ایریشمک	İrişmek
ایرسال	İrsal
ایرتیبات	İrtibat
ایرتیجا	İrtica
ایرتیفاع	İrtifa
ایرتیحال	İrtihal
ایرتیکاپ	İrtikap
ایرتیسام	İrtisam
ایسا	İsa
ایساله	İsale
ایسار	İsar
ایسبات	İsbat
ایسکله	İskele
ایسکان	İskan
ایسکارپین	İskarpin
ایسکندر	İskender
ایسکونتو	İskonto
ایسلام	İslam
ایسلامیت	İslamiyet
ایسلاو	İslav
ایسلاویزم	İslavizm
ایسلیک	İslik
ایسلیم	İslim
ایسمت	İsmet
ایسمیک	İsmik
ایسمیم	İsmim
ایسپات	İspat
ایسپانیول	İspanyol
ایسپیرتو	İspirto
ایستاسیون	İstasyon
ایستاتیستیک	İstatistik
ایستکسز	İsteksiz
ایستمه	İsteme
ایستنچ	İstenç
ایستمک	İstemek
ایستری	İsteri
ایستین	İsteyen
ایستیکامت	İstikamet
ایستیکبال	İstikbal
ایستیکلال	İstiklal
ایستیلاجی	İstilacı
ایستیلا	İstila
ایستیملاک	İstimlak
ایستیمنا	İstimna
ایستیمرار	İstimrar
ایستیناف	İstinaf
ایستینات	İstinat
ایستینکاف	İstinkaf
ایستینساح	İstinsah
ایستینتاق	İstintak
ایستیراحات	İstirahat
ایستیردات	İstirdat
ایستیسمار	İstismar
ایستیشاره	İstişare
ایستوا	İstiva
ایستیحاله	İstihale
ایستیخبارات	İstihbarat
ایستیخدام	İstihdam
ایستیخکاک	İstihkak
ایستیحلال	İstihlal
ایستیخراج	İstihraç
ایستیخسال	İstihsal
ایستیکرار	İstikrar
ایستینکا	İstinkâ
ایستیراک	İstirak
ایسوچ	İsveç
ایسویچره	İsviçre
ایسیان	İsyan
ایشارت	İşaret
ایشارتچی	İşaretçi
ایشارت‌لمک	İşaretlemek
ایشارت‌لشمک	İşaretleşmek
ایش‌باشی	İşbaşı
ایش‌بیرلیگی	İşbirliği
ایشچیلیک	İşçilik
ایشچی	İşçi
ایش‌اییش	İşleyiş
ایش‌غالییه	İşgaliye
ایش‌غال	İştigal
ایش‌گورن	İşgören
ایشیتمک	İşitmek
ایشیتسل	İşitsel
ایش‌کمبه	İşkembe
ایش‌کولیک	İşkolik
ایش‌کنجه	İşkence
ایش‌کور	İşkur
ایشلم	İşlem
ایشلمک	İşlemek
ایشلو	İşlev
ایشلیک	İşlik
ایش‌پورتا	İşporta
ایشتاح	İştah
ایشتراک	İştirak
ایشتراکچی	İştirakçi
ایش‌ورن	İşveren
ایسیان‌کار	İsyankar
ایتاعات	İtaat
ایتالیک	İtalik
ایتالیا	İtalya
ایتالیا‌نجه	İtalyanca
ایتاعات‌سزلیک	İtaatsizlik
ایتم	İtem
ایتهال	İthal
ایتهاف	İthaf
ایتی‌راف	İtiraf
ایتی‌راز	İtiraz
ایتی‌دال	İtidal
ایتی‌مات	İtimat
ایتی‌رازجی	İtirazcı
ایتی‌بار	İtibar
ایتی‌فاک	İttifak
ایتی‌حات	İttihat
ایتی‌رمک	İttirmek
ایتی‌فاکن	İttifaken
ایتی‌ساف	İttisaf
ایتی‌سال	İttisal
ایتی‌حاز	İttihaz
ایتی‌ن	İttin
ایتی‌رمه	İttirme
ایتی‌یاز	İtyaz
ایوان	İvan
ایواز	İvaz
ایودی	İvedi
ایوینتی	İvinti
ایومه	İvme
اییلک	İyelik
ایگی	İyi
ایگی‌جه	İyice
ایگی‌لیک	İyilik
ایگی‌مسر	İyimser
ایون	İyon
ایونیک	İyonik
ایز	İz
ایزافی	İzafi
ایزاح	İzah
ایزاحات	İzahat
ایزاحات‌نامه	İzahatname
ایزاله	İzale
ایزبه	İzbe
ایز‌دواچ	İzdivaç
ایز‌دش	İzdeş
ایزگه	İzge
ایزهار	İzhar
ایزل‌نیم	İzlenim
ایزل‌مک	İzlemek
ایزل‌ن‌بیلیر	İzlenebilir
ایزل‌یچی	İzleyici
ایز‌ماریت	İzmarit
ایز‌میت	İzmit
ایز‌نیک	İznik
ایز‌او‌الکتریک	İzoelektrik
ایز‌او‌فون	İzofon
ایز‌وله	İzole
ایز‌ولاسیون	İzolasyon
ایز‌ومر	İzomer
ایز‌ومرف	İzomorf
ایز‌وتوپ	İzotop
ایز‌وتروپ	İzotrop
ایزت	İzzet
جگوار	Jaguar
جکار	Jakar
جکارلی	Jakarlı
جکوبن	Jakoben
جکوبنیزم	Jakobenizm
جکوزی	Jakuzi
جاله	Jale
جالوزی	Jaluzi
جامبون	Jambon
جندارما	Jandarma
جانجان	Janjan
جانجانلی	Janjanlı
جانر	Janr
جانت	Jant
جاپون	Japon
جاپون‌آرمودی	Japon armudu
جاپون‌بالیغی	Japon balığı
جاپون‌بزی	Japon bezi
جاپون‌جه	Japonca
جاپون‌الماسی	Japon elması
جاپون‌اریگی	Japon eriği
جاپون‌گولی	Japon gülü
جاپون‌حورماسی	Japon hurması
جاپون‌کاکتوسی	Japon kaktüsü
جاپون‌سارماشیغی	Japon sarmaşığı
جارگون	Jargon
جارس	Jarse
جارتیر	Jartiyer
جه	Je
جل	Jel
جلاتین	Jelatin
جلاتین‌لمه	Jelatinleme
جلاتین‌لمک	Jelatinlemek
جلاتینلی	Jelatinli
جلاتین‌سز	Jelatinsiz
جل‌شمه	Jelleşme
جل‌شمک	Jelleşmek
جلوز	Jeloz
جنراسیون	Jenerasyon
جنراتور	Jeneratör
جنریک	Jenerik
جنوسیت	Jenosit
جئودزی	Jeodezi
جئودینامیک	Jeodinamik
جئوفیزیک	Jeofizik
جئوفیزیکچی	Jeofizikçi
جئوکیمیا	Jeokimya
جئوکیمیاچی	Jeokimyacı
جئولوگ	Jeolog
جئولوژی	Jeoloji
جئولوژیک	Jeolojik
جئومورفولوگ	Jeomorfolog
جئومورفولوژی	Jeomorfoloji
جئومورفولوژیک	Jeomorfolojik
جئوپولیتیک	Jeopolitik
جئوسانکلینال	Jeosenklinal
جئوسانکلیزم	Jeosantrizm
جئوسنکلینال	Jeosenklinal
جئوسیسیمیک	Jeosismik
جئوترمال	Jeotermal
جئوترمال‌انرژی	Jeotermal enerji
جئوترمی	Jeotermi
جئوترمیک	Jeotermik
جئوتروپیزم	Jeotropizma
جرسی	Jersey
جست	Jest
جت‌موتورو	Jet motoru
جتون	Jeton
جتون‌جو	Jetoncu
جتون‌جولوک	Jetonculuk
جت‌یاقتی	Jet yakıtı
جت‌یورغونلوغو	Jet yorgunluğu
جیگ	Jig
جیگولو	Jigolo
جیگولولوک	Jigololuk
جیمناستیک	Jimnastik
جیمناستیکچی	Jimnastikçi
جیمناستیکچیلیک	Jimnastikçilik
جینکولوگ	Jinekolog
جینکولوژی	Jinekoloji
جینکولوژیک	Jinekolojik
جیپس	Jips
جیوجیتسو	Jiujitsu
جیوجیتسو‌جو	Jiujitsucu
جوکر	Joker
جوکی	Jokey
جوکیلی	Jokeyli
جوکی‌لیک	Jokeylik
جوکی‌سز	Jokeysiz
جورجت	Jorjet
جوله	Jöle
جوله‌لی	Jöleli
جوله‌سز	Jölesiz
جون	Jön
جون‌پرومیه	Jönprömiye
جودو	Judo
جودو‌جو	Judocu
جودو‌جولوک	Judoculuk
جول	Jul
جول‌لوک	Jullük
جورنال	Jurnal
جورنال‌جی	Jurnalci
جورنال‌جیلیک	Jurnalcilik
جورنال‌لمه	Jurnalleme
جورنال‌لمک	Jurnallemek
جورو	Juro
جوبیتر	Jüpiter
جوبون	Jüpon
جوری	Jüri
جوت	Jüt
کاباحت	Kabahat
کاباحتلی	Kabahatli
کاباک‌چی	Kabakçı
کاباک‌لیک	Kabaklık
کاباک‌چیلیک	Kabakçılık
کابالیک	Kabalık
کاباریک	Kabarık
کاباریش	Kabarış
کابیر‌لیک	Kabirlik
کابلو‌سز	Kablosuz
کابوک‌لو	Kabuklu
کابول‌لنمک	Kabullenmek
کابورغا‌لیک	Kaburgalık
کابیله	Kabile
کادی‌لیک	Kadılık
کادین‌جه	Kadınca
کادین‌لیک	Kadınlık
کادین‌سی	Kadınsı
کافه‌تاریا	Kafeterya
کافی‌یه	Kafiye
کافیله	Kafile
کاه‌رامان	Kahraman
کاه‌یا	Kahya
کالاک‌ماک	Kalakmak
کالاک‌لامه	Kalaklama
کالاک‌لی	Kalaklı
کالاک‌لیک	Kalaklık
کالم‌لیک	Kalemlik
کاله‌سی	Kalesi
کالی‌جی	Kalıcı
کالک‌ماک	Kalkmak
کالکیش	Kalkış
کالکیش‌ماک	Kalkışmak
کالکیش‌مه	Kalkışma
کالکین‌ماک	Kalkınmak
کالکین‌مه	Kalkınma
کالکان‌ماک	Kalkanmak
کال‌ماک	Kalmak
کالپاغی	Kalpağı
کالپاک‌چی	Kalpakçı
کامپانیا	Kampanya
کامیون‌ت	Kamyonet
کانگرن	Kangren
کانی	Kanı
کانیت	Kanıt
کانیت‌لاماک	Kanıtlamak
کانیت‌لانماک	Kanıtlanmak
کانلی	Kanlı
کانلی‌جه	Kanlıca
کانون	Kanun
کانون‌نامه	Kanunname
کاپاسیت	Kapasite
کاپاک	Kapak
کاپالی	Kapalı
کاپ‌لاماک	Kaplamak
کاپ‌لام	Kaplam
کاپ‌لاما‌جی	Kaplamacı
کاپیتولاسیون	Kapitülasyon
کاپ‌ماک	Kapmak
کاپ‌سام	Kapsam
کاپ‌ساملی	Kapsamlı
کاپ‌ساییش	Kapsayış
کاپ‌شون	Kapşon
کارا	Kara
کارا‌باتاک	Karabatak
کارا‌بیبر	Karabiber
کارا‌بورسا	Karaborsa
کارا‌جیگر	Karaciğer
کاراف	Karaf
کارا‌حندیبا	Karahindiba
کاراکتر	Karakter
کارا‌لامه	Karalama
کارار	Karar
کارار‌نامه	Kararname
کارارلی	Kararlı
کارار‌ماک	Kararmak
کارار‌تماک	Karartmak
کارا‌سو	Karasu
کارا‌تاختا	Karatahta
کاردش	Kardeş
کاردش‌لیک	Kardeşlik
کارغی	Kargı
کارگو	Kargo
کارما	Karma
کارماشیک	Karmaşık
کارماشا	Karmaşa
کارناوال	Karnaval
کارنه	Karne
کارو	Karu
کارشی	Karşı
کارشی‌لیک	Karşılık
کارشی‌لاشماک	Karşılaşmak
کارشیت	Karşıt
کارتون	Karton
کارتو‌پو	Kartopu
کارت‌ویزیت	Kartvizit
کارون	Karun
کارین‌جه	Karınca
کاریشیک	Karışık
کاریش‌ماک	Karışmak
کاریشیم	Karışım
کارپوز	Karpuz
کارسی‌لاماک	Karsılamak
کارتال	Kartal
کارتل	Kartel
کارت‌پوستال	Kartpostal
کاریولا	Karyola
کاسابا	Kasaba
کاساپ	Kasap
کاساپ‌لیک	Kasaplık
کاست	Kast
کاسکت	Kasket
کاسا	Kasa
کاسوت	Kasvet
کاسوت‌لی	Kasvetli
کاسیرغا	Kasırga
کاسییر	Kasiyer
کاسییر‌لیک	Kasiyerlik
کاسک	Kask
کاسناک	Kasnak
کات	Kat
کاتالیزور	Katalizör
کاتیل‌ماک	Katılmak
کاتیلیم	Katılım
کاتیل	Katil
کاتیل‌جه	Katilce
کاتیل‌جیلیک	Katilcilik
کاتیلیم‌جی	Katılımcı
کاتیل‌لیک	Katilik
کات‌لاماک	Katlamak
کات‌مان	Katman
کات‌مر	Katmer
کاتولیک	Katolik
کاتراک	Katrak
کاتران	Katran
کات‌سایی	Katsayı
کاواک	Kavak
کاوانوز	Kavanoz
کاوغا	Kavga
کاوغا‌جی	Kavgacı
کاوغا‌کار	Kavgakâr
کاولاک	Kavlak
کاورام	Kavram
کاوراماک	Kavramak
کاورامیش	Kavramış
کاوراییش	Kavrayış
کاورام‌لاشترماک	Kavramlaştırmak
کاووک	Kavuk
کایاک	Kayak
کایا	Kaya
کایان	Kayan
کای‌بولماک	Kaybolmak
کای‌دیرماک	Kaydırmak
کای‌غی	Kaygı
کای‌ماک	Kaymak
کای‌ماکام	Kaymakam
کای‌ماکام‌لیک	Kaymakamlık
کای‌ماک‌لیک	Kaymaklık
کای‌ناک	Kaynak
کای‌ناتاراک	Kaynatarak
کای‌سری	Kayseri
کازان	Kazan
کازانچ	Kazanç
کازان‌دیرماک	Kazandırmak
کازه	Kaza
کازه‌ان	Kazaen
کازیماک	Kazımak
کازان‌ماک	Kazanmak
کازانچ‌لی	Kazançlı
کازیک‌لی	Kazıklı
کاز‌ماک	Kazmak
کباب	Kebap
کفالت	Kefalet
کفارت	Kefaret
کفیل	Kefil
کفیل‌یم	Kefilim
کفیل‌اولماک	Kefil olmak
کفیل‌سز	Kefilsiz
کچی	Keçi
کچه‌جی	Keçeci
کچه‌لمک	Keçelemek
کله‌بک	Kelebek
کله‌پچه	Kelepçe
کله‌پیر	Kelepir
کمر	Kemer
کمر‌لمک	Kemerlemek
کمیک	Kemik
کمیک‌سز	Kemiksiz
کمیر‌گن	Kemirgen
کنار‌محله	Kenar mahalle
کنار‌سوس	Kenar süs
کندی	Kendi
کندینه	Kendine
کندینی	Kendini
کندیلک	Kendilik
کندینی‌بیلمز	Kendini bilmez
کندینی‌گوسترمک	Kendini göstermek
کندی‌حالنده	Kendi halinde
کنه	Kene
کنه‌ویر	Kenevir
کنه‌تلمک	Kenetlemek
کنتین	Kentin
کنت‌لشمک	Kentleşmek
کنت‌لشمه	Kentleşme
کنیا	Kenya
کپ‌چه	Kepçe
کپنک	Kepenk
کرمت	Keramet
کره	Kere
کره‌وت	Kerevet
کره‌ویز	Kereviz
کریز	Keriz
کریز‌لیک	Kerizlik
کرک‌نز	Kerkenez
کروان	Kervan
کروان‌جی	Kervancı
کسافت	Kesafet
کسل	Kesel
کسن	Kesin
کسی‌جی	Kesici
کسم	Kesim
کسم‌لیک	Kesimlik
کسکین	Keskin
کسکین‌لیک	Keskinlik
کسمه	Kesme
کستانه	Kestane
کستیرمک	Kestirmek
کتن	Keten
کته	Kete
کتوم	Ketum
کشی‌ش	Keşiş
کشی‌ش‌لیک	Keşişlik
کش‌مکش	Keşmekeş
کای‌فی	Keyfi
کای‌ف	Keyif
کای‌ف‌سز	Keyifsiz
کای‌ف‌سز‌لیک	Keyifsizlik
کیدم	Kıdem
کیمت	Kıymet
کیمت‌لی	Kıymetli
کیمت‌سز	Kıymetsiz
کیمت‌ورمک	Kıymet vermek
کیز‌غا	Kızağa
کیزار‌ماک	Kızarmak
کیزار‌میش	Kızarmış
کیزار‌تماک	Kızartmak
کیز‌غین	Kızgın
کیزیل	Kızıl
کیز‌لیک	Kızlık
کیز‌ماک	Kızmak
کیزیم	Kızım
کیزیل‌جه	Kızılca
کبیریت	Kibrit
کبیر	Kebir
کبیر‌لنمک	Kibirlenmek
کبار	Kibar
کبار‌جه	Kibarca
کبار‌لیک	Kibarlık
کیکاره	Kicare
کیسا	Kısa
کیسا‌جه	Kısaca
کیسا‌دوره	Kısa devre
کیسا‌لیک	Kısalık
کیس‌کانچ	Kıskanç
کیس‌کان‌ماک	Kıskanmak
کیس‌کانیش	Kıskanış
کیس‌کاچ	Kıskaç
کیش	Kış
کیش‌لیک	Kışlık
کیش‌لا	Kışla
کیش‌لاک	Kışlak
کیش‌لاماک	Kışlamak
کیش‌کیرت‌ماک	Kışkırtmak
کیش‌کیر‌تی‌جی	Kışkırtıcı
کیش‌کیر‌ماک	Kışkırmak
کیتا	Kıta
کیت‌لیک	Kıtlık
کویل‌جیم	Kıvılcım
کوی‌راک	Kıvrak
کوی‌رماک	Kıvırmak
کوی‌ران‌ماک	Kıvranmak
کوی‌ریم	Kıvrım
کیه‌افت	Kıyafet
کیه‌ی	Kıyı
کیه‌ما	Kıyma
کیه‌ما‌کیمت	Kıyma kıymet
کیز	Kız
کیزاک	Kızak
کیز‌غین‌لیک	Kızgınlık
کیزیش‌ماک	Kızışmak
کیزیش‌میش	Kızışmış
کیر	Kır
کیر‌غین	Kırgın
کیریل‌ماک	Kırılmak
کیریم‌لی	Kırımlı
کیریشیک	Kırışık
کیریشت‌رماک	Kırıştırmak
کیریشیک‌لیک	Kırışıklık
کیریت‌ماک	Kırıtmak
کیریتل‌ماک	Kırıtlmak
کیس‌کاچ‌لاماک	Kıskaçlamak
کیسیک	Kısık
کیسیم	Kısım
کیسیم‌کیسیم	Kısım kısım
کیتیر	Kıtır
کوی‌ریل‌ماک	Kıvrılmak
کابالا	Kabala
کابان	Kaban
کابار‌ماک	Kabarmak
کابا‌ساکال	Kabasakal
کابات	Kabat
کابه	Kabe
کابیلی‌یت	Kabiliyet
کاچاک	Kaçak
کاچار	Kaçar
کاچ‌گون‌لوک	Kaçgünlük
کاچیک	Kaçık
کاچیش	Kaçış
کاچ‌ماک	Kaçmak
کاچتا	Kaçta
کاچی‌ورمک	Kaçıvermek
کاداو‌را	Kadavra
کادار	Kadar
کاده	Kadeh
کادم	Kadem
کادرو‌لو	Kadrolu
کافا	Kafa
کافا‌دار	Kafadar
کافا‌لی	Kafalı
کافاسی‌بوزوک	Kafasıbozuk
کافس	Kafes
کاه‌هار	Kahhar
کاه‌یر	Kahır
کاه‌یرلا	Kahırla
کاه‌کاها	Kahkaha
کاه‌په	Kahpe
کایم	Kaim
کای‌مه	Kaime
کاکا	Kaka
کاک‌ماک	Kakmak
کاکتوس	Kaktüs
کالا‌بالیک	Kalabalık
کالا‌کال‌ماک	Kalakalmak
کالامیش	Kalamış
کال‌چا	Kalça
کاله‌جی	Kaleci
کالندر	Kalender
کاله‌وی	Kalevi
کالفا	Kalfa
کالیبر	Kalibre
کالی‌فی‌یه	Kalifiye
کالین	Kalın
کالین‌لیک	Kalınlık
کالیت	Kalite
کالکیک	Kalkık
کالکان‌جی	Kalkancı
کالوری‌فر	Kalorifer
کالسا	Kalsa
کال‌سین	Kalsın
کالین‌لاشماک	Kalınlaşmak
کالپ‌لی	Kalpli
کاما	Kama
کامان	Kaman
کامبور	Kambur
کامت	Kamet
کامیش	Kamış
کامپ‌چی	Kampçı
کامپ‌تا	Kampta
کانا	Kana
کانادی	Kanadı
کانا‌دیکیریک	Kanadıkırık
کانا‌ماک	Kanamak
کاناریا	Kanarya
کان‌جه	Kanca
کان‌ماک	Kanmak
کان‌سر	Kanser
کان‌تار	Kantar
کاپ	Kap
کاپا	Kapa
کاپا‌ماک	Kapamak
کاپامیش	Kapamış
کاپان	Kapan
کاپان‌جی	Kapancı
کاپار‌لیک	Kaparlık
کاپی	Kapı
کاپی‌جی	Kapıcı
کاپی‌دان	Kapıdan
کاپ‌کارا	Kapkara
کاپ‌لان	Kaplan
کاپ‌لی‌جه	Kaplıca
کاپورتا	Kaporta
کاپ‌ساماک	Kapsamak
کاپ‌سول	Kapsül
کاپ‌تان	Kaptan
کاپوت	Kaput
کارا‌کول	Karakol
کارا‌کورو	Karakuru
کارا‌لتی	Karaltı
کارار‌ما	Kararma
کارار‌سز	Kararsız
کارغا	Karga
کارغا‌ماک	Kargamak
کارین	Karın
کارین‌جه‌لی	Karıncalı
کارین‌لی	Karınlı
کاریش	Karış
کاریش‌ترماک	Karıştırmak
کاریز‌ماتیک	Karizmatik
کاری	Karı
کاری‌کاتور	Karikatür
کار‌کاس	Karkas
کار‌پوز	Karpuz
کار‌سام‌باچ	Karsambaç
کار‌سز	Karsız
کار‌تون	Karton
کار‌تو‌پو	Kartopu
کار‌ت‌ویزیت	Kartvizit
کارشی‌لاماک	Karşılamak
کاس‌لی	Kaslı
کاس‌ماک	Kasmak
کاس‌ما	Kasma
کاسپ	Kasp
کاست‌اتمک	Kastetmek
کاستی‌لیا	Kastilya
کاتار	Katar
کات‌اتمک	Katetmek
کاتی	Katı
کاتیک‌سز	Katıksız
کات‌لان‌ماک	Katlanmak
کات‌لی	Katlı
کات‌ماک	Katmak
کات‌ران	Katran
کات‌تی‌ین	Kattiyen
کاوال	Kaval
کاویم	Kavim
کاویس	Kavis
کاوروک	Kavruk
کاور‌ما	Kavurma
کاووش‌ماک	Kavuşmak
کاووشوم	Kavuşum
کای	Kay
کایا‌لیک	Kayalık
کایار	Kayar
کای‌بت‌مک	Kaybetmek
کای‌بول‌ماک	Kaybolmak
کای‌دیراک	Kaydırak
کای‌دیر‌ماک	Kaydırmak
کاییک	Kayık
کایین	Kayın
کاییر‌ماک	Kayırmak
کایپ	Kayıp
کاییت	Kayıt
کاییت‌سز	Kayıtsız
کای‌ناک‌چی	Kaynakçı
کای‌نار	Kaynar
کای‌پاک	Kaypak
کای‌سری‌لی	Kayserili
کاز	Kaz
کازا‌دان	Kazadan
کازاک	Kazak
کازان‌دیر‌ماک	Kazandırmak
کازی	Kazı
کازی‌ماک	Kazımak
کازین‌ماک	Kazınmak
کازیت‌ماک	Kazıtmak
کازولت	Kazulet
کب‌زه‌جی	Kebzeci
کدی	Kedi
کفال	Kefal
کفن	Kefen
کفی‌یه	Kefiye
کک	Kek
کک‌مه	Kekeme
کک‌لیک	Keklik
کل	Kel
کله‌ش	Keleş
کله	Kelle
کمال	Kemal
کمانه	Kemane
کمان‌جی	Kemancı
کمیر‌مک	Kemirmek
کنان	Kenan
کندیل‌گین‌دن	Kendiliğinden
کنه‌ت	Kenet
کنه‌ت‌لنمک	Kenetlenmek
کپ	Kep
کپک	Kepek
کرم	Kerem
کره‌خانه	Kerhane
کری‌مه	Kerime
کرتک	Kertik
کسات	Kesat
کسه	Kese
کسه‌ک	Kesek
کسه‌لی	Keseli
کسر	Kesir
کسیف	Kesif
کسیک	Kesik
کسن‌لیک	Kesinlik
کست	Kesit
کسمک	Kesmek
کسم‌جه	Kesmece
کسرت	Kesret
کت	Ket
کو‌گیر	Kevgir
کز	Kez
کز‌زاپ	Kezzap
کیدم‌لی	Kıdemli
کیرا‌عته‌خانه	Kıraathane
کیراچ	Kıraç
کیراعات	Kıraat
کیراغی	Kırağı
کیران	Kıran
کیرات	Kırat
کیربا	Kırba
کیر‌باچ	Kırbaç
کیریک	Kırık
کیریل‌گان	Kırılgan
کیریش‌ماک	Kırışmak
کیر‌کا‌غاچ	Kırkağaç
کیر‌کلیک	Kırklık
کیر‌ما	Kırma
کیر‌میز‌ی	Kırmızı
کیسا‌لت‌ماک	Kısaltmak
کیسیر	Kısır
کیسیت	Kısıt
کیسیت‌لاماک	Kısıtlamak
کیس‌کا‌چا	Kıskaça
کیس‌مت	Kısmet
کیس‌من	Kısmen
کیس‌پت	Kıspet
کیس‌سا	Kıssa
کیس‌تر‌ماک	Kıstırmak
کیشین	Kışın
کیت	Kıt
کیوام	Kıvam
کویانچ	Kıvanç
کوی‌رچیک	Kıvırcık
کیه‌اس	Kıyas
کیم‌ماک	Kıymak
کیزان	Kızan
کیزار‌ت‌ماک	Kızartmak
کیز‌جه‌گیز	Kızcağız
کیزیل‌چیک	Kızılcık
کیز‌سام	Kızsam
کی‌فای‌ت‌سز	Kifayetsiz
کیک‌لوپ	Kiklop
کیل	Kıl
کیلر	Kiler
کلی‌دی	Kilidi
کلی‌سه	Kilise
کلی‌ت‌لمک	Kilitlemek
کلو‌گرام	Kilogram
کلیت	Kilit
کیم	Kim
کیم‌لیک	Kimlik
کیم‌سه	Kimse
کیمیا‌سال	Kimyasal
کیمیا	Kimya
کین	Kin
کینا	Kına
کینا‌ماک	Kınamak
کینا‌لی	Kınalı
کین‌لان‌ماک	Kınlanmak
کی‌پیر‌تی	Kıpırtı
کیراغی‌لی	Kırağılı
کیز‌کاردش	Kızkardeş
کیتیریک	Kıytırık
کیلاووز	Kılavuz
کیلچ	Kılıç
کیلف	Kılıf
کیلک	Kılık
کیل‌ماک	Kılmak
کی‌پیر‌دا‌ماک	Kıpırdamak
کی‌پیر‌دا‌ت‌ماک	Kıpırdatmak
لابا	Laba
لابیرنت	Labirent
لاچی‌ورت	Lacivert
لادس	Lades
لاف	Laf
لافا‌زان	Lafazan
لاف‌لامه	Laflama
لاف‌لاماک	Laflamak
لاف‌لات‌ماک	Laflatmak
لاف‌زی	Lafzî
لاگا‌لوگا	Lagaluga
لاگون	Lagün
لاغیم	Lağım
لاغ‌وت‌مک	Lağvetmek
لاحیک	Lahik
لاحی‌که	Lahika
لاح‌ما‌جون	Lahmacun
لاحوت	Lahut
لاکاپ	Lakap
لاکاپ‌لی	Lakaplı
لاکین	Lakin
لال	Lal
لاله	Lale
لاله‌لیک	Lalelik
لاله‌ت‌تایین	Lalettayin
لام‌بادر	Lambader
لام‌با	Lamba
لام‌با‌لی	Lambalı
لام‌بری	Lambri
لامل	Lamel
لامل‌سور	Lamelsever
لامی‌نه	Lamine
لامی‌نت	Laminet
لان	Lan
لانت	Lanet
لانت‌لمک	Lanetlemek
لان‌غیرت	Langırt
لان‌سمان	Lansman
لاپا	Lapa
لاپا‌جی	Lapacı
لاپایا	Lapaya
لاپ‌سکی	Lapseki
لاپ‌سوس	Lapsus
لارا	Lara
لارا‌شین	Laraşin
لار‌وا	Larva
لاستیک	Lastik
لاستیک‌لی	Lastikli
لاتا	Lata
لاتیف	Latif
لاتی‌فه‌لیک	Latifelik
لاتی‌فه	Latife
لاتی‌نجه	Latince
لات‌رینا	Latrina
لاو	Lav
لاوا‌بو	Lavabo
لاوان‌تا	Lavanta
لاوین‌یوم	Lavinyum
لاز	Laz
لازا‌نیا	Lazanya
لاز‌جه	Lazca
لازیم	Lazım
لازیم‌لیک	Lazımlık
له	Le
له‌بله‌بی	Leblebi
له‌جیک	Lecik
له‌فکه	Lefke
له‌گال	Legal
له‌گا‌لی‌ته	Legalite
له‌گن	Leğen
له‌حیم	Lehim
له‌حیم‌جی	Lehimci
له‌حیم‌لمه	Lehimleme
له‌جاند	Lejand
له‌جیون	Lejyon
له‌جیو‌نر	Lejyoner
له‌که	Leke
له‌که‌لی	Lekeli
له‌که‌لمک	Lekelemek
له‌که‌سز	Lekesiz
له‌کسی‌کون	Leksikon
له‌ما	Lema
له‌مان	Leman
له‌ما‌عات	Lemaat
له‌می	Lemı
له‌مور	Lemur
له‌نف	Lenf
له‌نفا‌تیک	Lenfatik
له‌نفو‌ما	Lenfoma
له‌نس	Lens
له‌نتو	Lento
له‌و	Leo
له‌و‌پار	Leopar
له‌پرا	Lepra
له‌پره‌لیک	Leprelik
له‌پوس	Lepus
له‌ش	Leş
له‌ش‌جی	Leşçi
له‌ش‌لمک	Leşlemek
له‌ش‌لی	Leşli
له‌ش‌مه	Leşme
له‌ش‌مک	Leşmek
له‌تاف‌ت	Letafet
له‌تار‌جی	Letarji
له‌تار‌گیک	Letargik
له‌وا‌زیم	Levazım
له‌وا‌زیمات	Levazımat
له‌وان‌ت	Levant
له‌و‌ها	Levha
له‌و‌ها‌لیک	Levhalık
له‌و‌ها‌لی	Levhalı
له‌وه	Levh
له‌وه‌ی‌محفوظ	Levh-i Mahfuz
له‌و‌یه‌لی	Levyeli
له‌ز‌ت	Lezzet
له‌ز‌ت‌لی	Lezzetli
له‌ز‌ت‌سز	Lezzetsiz
لی‌برال	Liberal
لی‌برا‌لیزم	Liberalizm
لی‌بیدو	Libido
لی‌بوش	Liboş
لی‌جیک	Licik
لی‌در	Lider
لی‌در‌لیک	Liderlik
لی‌در‌لیک‌ته	Liderlikte
لی‌دیا	Lidya
لیف	Lif
لیف‌لی	Lifli
لیف‌سل	Lifsel
لیگ	Lig
لی‌گا‌سیون	Ligasyon
لی‌گا‌تور	Ligatür
لیگ‌ده	Ligde
لیگ‌ده‌کی	Ligdeki
لیگ‌لر	Ligler
لیگ‌ین	Ligin
لی‌کید‌ته	Likidite
لی‌کور	Likör
لی‌لا	Lila
لی‌لاک	Lilâk
لی‌من	Limen
لی‌م‌خانه	Limhane
لی‌میت	Limit
لی‌میت‌ت	Limitet
لی‌میت‌لی	Limitli
لی‌مون	Limon
لی‌مونا‌تا	Limonata
لی‌مون‌جو	Limoncu
لی‌مون‌لوک	Limonluk
لی‌مونی	Limoni
لی‌مون‌سو	Limonsu
لی‌مان	Liman
لی‌مان‌جی	Limancı
لی‌مان‌سز	Limansız
لی‌م‌نولوژی	Limnoloji
لی‌نچ	Linç
لی‌نگوا	Lingua
لی‌نک	Link
لی‌نک‌لمه	Linkleme
لی‌نتر	Linter
لیپ	Lip
لی‌پیت	Lipit
لی‌پوم	Lipom
لی‌پو‌سار‌کوم	Liposarkom
لی‌را	Lira
لی‌ریزم	Lirizm
لی‌سه	Lise
لی‌سه‌لی	Liseli
لی‌سانس	Lisans
لی‌سانس‌لی	Lisanslı
لی‌سانس‌سز	Lisanssız
لی‌سه‌یه	Liseye
لی‌سته	Liste
لی‌سته‌لی	Listeli
لی‌سته‌سز	Listesiz
لی‌سته‌لنمک	Listelenmek
لی‌تا‌نی	Litani
لی‌ت‌راتور	Literatür
لی‌تو‌گرافی	Litografi
لی‌تر‌لیک	Litrelik
لی‌تر	Litre
لی‌تیوم	Lityum
لی‌وا	Liva
لی‌وار	Livar
لی‌وار‌دا	Livarda
لی‌یا‌کا‌ت‌سز	Liyakatsiz
لی‌یا‌کا‌ت	Liyakat
لی‌یا‌کا‌ت‌سز‌لیک	Liyakatsizlik
لی‌زا	Liza
لی‌زول	Lizol
لی‌زو‌زوم	Lizozom
لو‌بی	Lobi
لو‌بی‌جی	Lobici
لو‌بی‌سل	Lobisel
لو‌بوت	Lobut
لو‌جه	Loca
لو‌جه‌جی	Locacı
لو‌جه‌ک	Locak
لو‌دوس	Lodos
لو‌دوس‌لو	Lodoslu
لو‌غو‌سا	Loğusa
لو‌غو‌سا‌لیک	Loğusalık
لو‌غو‌سا‌لاش‌ماک	Loğusalaşmak
لوک	Lok
لو‌کال	Lokal
لو‌کان‌تا	Lokanta
لو‌کان‌تا‌لیک	Lokantalık
لو‌کا‌وت	Lokavt
لو‌ک‌ما	Lokma
لو‌ک‌ما‌جی	Lokmacı
لو‌کومو‌تیف	Lokomotif
لو‌کوم	Lokum
لو‌کوم‌جو	Lokumcu
لو‌لا	Lola
لو‌م‌بار	Lombar
لو‌م‌بوز	Lomboz
لو‌ن‌درا	Londra
لو‌ن‌گوز	Longoz
لوپ	Lop
لو‌پ‌چوک	Lopçuk
لو‌پی	Lopi
لو‌پور	Lopur
لو‌پور‌دا‌ماک	Lopurdamak
لور	Lor
لور‌جو	Lorcu
لور‌که	Lorke
لو‌سیون	Losyon
لوش	Loş
لوش‌لوک	Loşluk
لو‌تا	Lota
لو‌کوز	Lökoz
لو‌س‌می	Lösemi
لو‌س‌می‌لی	Lösemili
لو‌سی‌ته	Lösite
لو‌فر	Lüfer
لو‌گا‌ت	Lügat
لو‌گا‌ت‌چه	Lügatçe
لو‌گا‌ت‌لیک	Lügatlık
لو‌گا‌ت‌نامه	Lügatname
لو‌گا‌وی	Lügavi
لوک‌س	Lüks
لوک‌س‌لوک	Lükslük
لوک‌س‌چو	Lüksçü
لو‌له	Lüle
لو‌له‌جی	Lüleci
لو‌له‌تاش‌ی	Lületaşı
لو‌من	Lümen
لو‌م‌پن	Lümpen
لو‌نف	Lünf
لو‌نا‌پارک	Lünapark
لو‌توف	Lütuf
لو‌توف‌کار	Lütufkâr
لو‌توف‌کار‌لیک	Lütufkârlık
لو‌توف‌لو	Lütuflu
لو‌توف‌سز	Lütufsuz
لو‌ت‌فن	Lütfen
لو‌ت‌فی	Lütfi
لو‌توف‌سور	Lütufsever
لو‌زوم	Lüzum
لو‌زوم‌لو	Lüzumlu
لو‌زوم‌سز	Lüzumsuz
لو‌زوم‌سز‌لوک	Lüzumsuzluk
لو‌زوم‌ی‌یت	Lüzumiyet
ماح‌جوب‌یت	Mahcubiyet
ماهی‌یت‌سز‌لیک	Mahiyetsizlik
محروم‌یت	Mahrumiyet
مقص‌ت‌لی‌لیک	Maksatlılık
معقول‌یت	Makuliyet
معقول‌جه	Makulce
معلو‌ما‌ت‌لی	Malumatlı
معلو‌ما‌ت‌چی‌لیک	Malumatçılık
معلو‌ما‌ت‌سز‌لیک	Malumatsızlık
معلو‌لن	Malulen
معلو‌ل‌یت	Maluliyet
ماما‌فیه	Mamafih
مامو‌ل‌یت	Mamuliyet
معنا‌سز‌لیک	Manasızlık
معنی‌دار‌جه	Manidarca
معنی‌دار‌لاش‌ماک	Manidarlaşmak
معنی‌دار‌لاش‌تر‌ماک	Manidarlaştırmak
منطق‌سال‌لیک	Mantıksallık
منطق‌سز‌لاش‌تر‌ماک	Mantıksızlaştırmak
منطق‌لی‌لاش‌ترا‌بیل‌مک	Mantıklılaştırabilmek
معصوم‌یت	Masumiyet
معصوم‌لاش‌تر‌ماک	Masumlaştırmak
مات‌ما‌تیک‌لش‌مک	Matematikleşmek
مات‌ما‌تیک‌سل	Matematiksel
مات‌لاش‌ماک	Matlaşmak
مات‌لاش‌تر‌ماک	Matlaştırmak
مضبوط‌لوک	Mazbutluk
مذور‌یت	Mazuriyet
مذور‌سز	Mazursuz
م‌جال‌سز‌لیک	Mecalsizlik
مجبور‌یت	Mecburiyet
مجبور‌لاش‌تر‌ماک	Mecburlaştırmak
مجنون‌لاش‌ماک	Mecnunlaşmak
مدیا‌تیک‌لش‌مک	Medyatikleşmek
مدیا‌سز‌لیک	Medyasızlık
مفتون‌یت	Meftuniyet
مه‌گرسه	Meğerse
مه‌ها‌بت‌لی	Mehabetli
مه‌تر‌لش‌مک	Mehterleşmek
مکان‌سال‌لیک	Mekânsallık
مکان‌سز‌لیک	Mekânsızlık
مک‌تب‌لی	Mektepli
مک‌تب‌سز‌لیک	Mektepsizlik
مکروه‌لاش‌ماک	Mekruhlaşmak
ملان‌کولیک‌لیک	Melankoliklik
ملان‌کولی‌یه	Melankoliye
ملو‌درا‌ما‌تیک	Melodramatik
م‌ملکه‌ت‌لی‌لیک	Memleketlilik
م‌ملکه‌ت‌لش‌مک	Memleketleşmek
م‌منون‌یت	Memnuniyet
م‌منون‌یت‌سز‌لیک	Memnuniyetsizlik
م‌مور‌یت	Memuriyet
م‌نفا‌ت‌سز‌لیک	Menfaatsizlik
م‌نفی	Menfi
م‌نفور	Menfur
م‌نش‌ئینه	Menşeine
م‌نسو‌ب‌یت	Mensubiyet
م‌نسو‌پ‌سز‌لوک	Mensupsuzluk
م‌نتور‌لوک	Mentorluk
م‌نزیل‌سز‌لیک	Menzilsizlik
م‌راک‌لان‌در‌ماک	Meraklandırmak
م‌راک‌لی‌جه	Meraklıca
م‌ربوط‌یت	Merbutiyet
م‌ردا‌نه‌لیک	Merdanelik
م‌رحمت‌سز‌جه	Merhametsizce
م‌رحمت‌سز‌لیک	Merhametsizlik
م‌رک‌پ‌جه	Merkepçe
م‌رکز‌یلش‌مک	Merkezileşmek
م‌رکز‌یلش‌تر‌مک	Merkezileştirmek
م‌رکز‌سز‌لیک	Merkezsizlik
م‌ساعیه	Mesaiye
م‌ساعی‌خا‌ری‌جی	Mesaiharici
م‌سله‌لش‌مک	Meseleleşmek
م‌سله‌سز‌لیک	Meselesizlik
م‌س‌لکی‌یت	Meslekiyet
م‌س‌لک‌سز‌لیک	Mesleksizlik
م‌س‌نت‌سز‌لیک	Mesnetsizlik
م‌سرور‌یت	Mesruriyet
م‌سؤول‌یت	Mesuliyet
م‌سؤول‌یت‌سز‌لیک	Mesuliyetsizlik
م‌تا‌فور‌موز	Metaformoz
م‌تالاش‌ماک	Metalaşmak
م‌تالیز	Metalize
م‌تا‌مور‌فوز	Metamorfoz
م‌تا‌زوری	Metazori
م‌تین‌لیک	Metinlik
م‌تو‌دولو‌جیک	Metodolojik
م‌تو‌دولو‌جیک‌لش‌مک	Metodolojikleşmek
موجود‌یت	Mevcudiyet
موهوم‌یت	Mevhumiyet
موق‌عی	Mevkii
مولانا‌واری	Mevlanavari
موس‌م‌سل‌لیک	Mevsimsellik
موس‌م‌سز‌جه	Mevsimsizce
موس‌م‌سز‌لش‌مک	Mevsimsizleşmek
موضوع‌ات‌جه	Mevzuatça
موضوع‌ات‌سز‌لیک	Mevzuatsızlık
مزار‌لیق‌لار	Mezarlıklar
مز‌بله‌لیک	Mezbelelik
مذهب‌چی‌لیک	Mezhepçilik
مزون‌یت	Mezuniyet
مزون‌لاش‌ماک	Mezunlaşmak
مزون‌لاش‌تر‌ماک	Mezunlaştırmak
می‌جیر‌لاش‌ماک	Mıcırlaşmak
میده‌بولان‌دری‌جی	Midebulandırıcı
مید‌یه‌جی‌لیک	Midyecilik
می‌ه‌نک‌تاش‌ی	Mihenktaşı
می‌حرا‌پ‌سز‌لیک	Mihrapsızlık
می‌کرو‌ار‌گا‌نیز‌ما	Mikroorganizma
می‌کروس‌کو‌بیک	Mikroskobik
می‌کتار‌سز	Miktarsız
می‌لی‌تان‌لاش‌ماک	Militanlaşmak
می‌لی‌تان‌لاش‌تر‌ماک	Militanlaştırmak
می‌لی‌تری‌ک	Milimetrik
می‌لی‌تری‌ک‌لش‌مک	Milimetrikleşmek
می‌للی‌یت‌چی‌لیک	Milliyetçilik
می‌للی‌یت‌پ‌رور	Milliyetperver
می‌للی‌لش‌تر‌مک	Milliyleştirmek
می‌للی‌لش‌ترا‌مه‌مک	Millîleştirememek
می‌للی‌لش‌امه‌مک	Millîleşememek
می‌نا‌ره‌لش‌مک	Minareleşmek
می‌نیا‌تور‌لوک	Minyatürlük
می‌راس‌یه‌دی‌لیک	Mirasyedilik
می‌سا‌فیر‌سز	Misafirsiz
می‌سی‌له‌مه‌سز‌لیک	Misillemesizlik
می‌س‌کین‌لش‌مک	Miskinleşmek
می‌س‌کین‌لش‌تر‌ماک	Miskinleştirmek
می‌سیو‌نر‌لیک	Misyonerlik
می‌ت‌ها‌ت‌واری	Mithatvari
می‌زاج‌سز	Mizaçsız
می‌زا‌ح‌چی‌لیک	Mizahçılık
می‌زا‌ح‌سز‌لیک	Mizahsızlık
مو‌بی‌لی‌زا‌سیون	Mobilizasyon
مو‌بی‌لی‌ته	Mobilite
مو‌درن‌لش‌مک	Modernleşmek
مو‌درن‌لش‌تر‌مک	Modernleştirmek
مو‌درن‌لیک	Modernlik
مو‌در‌نیس‌ت‌جه	Modernistçe
مو‌دی‌فی‌یه	Modifiye
مو‌دول‌لن‌در‌مک	Modüllendirmek
مو‌دول‌سز‌لوک	Modülsüzlük
مو‌له‌کول‌ر‌لیک	Molekülerlik
مو‌نا‌رشی‌جی‌لیک	Monarşicilik
مو‌نو‌تون‌لوک	Monotonluk
مو‌نو‌تون‌لاش‌ماک	Monotonlaşmak
مو‌نو‌تون‌لاش‌تر‌ماک	Monotonlaştırmak
مو‌را‌لسز‌لیک	Moralsizlik
مو‌را‌لیز	Moralize
مو‌را‌لی‌زا‌سیون	Moralizasyon
مو‌تی‌وا‌سیو‌نل	Motivasyonel
مو‌تی‌وا‌سیو‌ن‌سز‌لوک	Motivasyonsuzluk
مو‌تو‌ریز	Motorize
مو‌تی‌وه	Motive
مو‌تی‌وه‌ا‌دی‌ل‌امه‌مک	Motive edilememek
مو‌تی‌وه‌اولا‌ماک	Motive olamamak
م‌حافظه‌کار‌جه	Muhafazakârca
م‌حافظه‌کار‌لیک	Muhafazakârlık
م‌حا‌ب‌ره‌سز‌لیک	Muhaberesizlik
م‌حافظه‌ا‌دیل‌مک	Muhafazaedilmek
م‌حک‌ک‌ک‌یت	Muhakkakiyet
م‌حا‌لفه‌ت‌سز‌لیک	Muhalefetsizlik
م‌حا‌لیف‌لش‌مک	Muhalifleşmek
م‌حا‌لیف‌لش‌امه‌مک	Muhalifleşememek
م‌حا‌ک‌مه‌لی	Muhakemeli
م‌حا‌ک‌مه‌سز‌لیک	Muhakemesizlik
م‌حا‌تا‌پ‌سز‌لیک	Muhatapsızlık
م‌ه‌بیر‌لیک	Muhbirlik
م‌ه‌ندس‌لیک	Mühendislik
م‌ه‌ندس‌لش‌مک	Mühendisleşmek
م‌ه‌ندس‌لش‌تر‌مک	Mühendisleştirmek
م‌وج‌ده‌لمک	Müjdelemek
م‌وکا‌فا‌ت‌لان‌در‌ماک	Mükâfatlandırmak
م‌وک‌م‌م‌لش‌تر‌مک	Mükemmelleştirmek
م‌وک‌م‌م‌لسز‌لیک	Mükemmelsizlik
م‌ولا‌کا‌ت‌چی‌لیک	Mülakatçılık
م‌ونا‌کا‌شا	Münakaşa
م‌ونا‌س‌به‌ت‌سز‌لیک	Münasebetsizlik
م‌ونا‌زا‌را	Münazara
م‌ور‌ب‌یه	Mürebbiye
م‌ورت‌جی‌لش‌مک	Mürtecileşmek
م‌ورت‌جی‌لیک	Mürtecilik
م‌ور‌وت‌لیک	Mürvetlik
م‌وسا‌با‌کا‌سز	Müsabakasız
م‌وسا‌حی‌پ‌لیک	Müsahiplik
م‌وسا‌ما‌حا‌سز‌لیک	Müsamahasızlık
م‌وس‌پ‌ت‌لیک	Müspetlik
م‌وس‌تا‌ک‌یل‌جه	Müstakilce
م‌وس‌ت‌س‌نا	Müstesna
م‌وس‌ت‌وزی	Müstevzi
م‌وت‌عا‌ه‌یت‌لیک	Müteahhitlik
م‌وت‌عا‌ک‌پ	Müteakip
م‌وت‌جا‌ویز	Mütecaviz
م‌وت‌د‌یین	Mütedeyyin
م‌وت‌وا‌زی‌جه	Mütevazıca
م‌وت‌وا‌زی‌لیک‌لا	Mütevazılıkla
م‌وت‌وا‌زی‌لاش‌ماک	Mütevazılaşmak
م‌وت‌و‌ل‌یت	Mütevellit
م‌وز‌ویر‌لیک	Müzevirlik
م‌وزی‌کا‌لی‌ته	Müzikalite
م‌وزی‌ک‌سز‌لیک	Müziksizlik
م‌وزی‌کولو‌ژی	Müzikoloji
م‌وزی‌ک‌س‌ور‌لیک	Müzikseverlik
م‌وزی‌س‌ین‌لیک	Müzisyenlik
م‌وبا‌لا‌غا‌سز‌لیک	Mübalağasızlık
م‌وجا‌ه‌یت‌لیک	Mücahitlik
م‌ودا‌ها‌ل‌جی‌لیک	Müdahalecilik
م‌ودا‌ویم‌لیک	Müdavimlik
م‌ود‌ت‌ین‌جه	Müddetince
م‌ودری‌ک‌جه	Müdrikçe
م‌وع‌ب‌ت‌لیک	Müebbetlik
م‌وس‌س‌ه‌سز‌لیک	Müessesesizlik
م‌وه‌م‌لیک	Mühimlik
م‌وج‌ده‌جی‌لیک	Müjdecilik
م‌ولا‌کا‌ت‌لی‌لیک	Mülakatlılık
م‌ونا‌فی‌ک‌لیک	Münafıklık
م‌ون‌ف‌ری‌ت‌لیک	Münferitlik
م‌ور‌ک‌ک‌پ‌چی‌لیک	Mürekkepçilik
م‌وزی‌کا‌ل‌لش‌تر‌مک	Müzikalleştirmek
ما‌کا‌را	Makara
ما‌سا	Masa
مو‌م	Mum
م‌یه‌وه	Meyve
م‌ک‌تو‌پ	Mektup
ما‌کا‌س	Makas
مو‌ر	Mor
ما‌وی	Mavi
م‌و‌ر‌ک‌ک‌پ	Mürekkep
م‌و‌زی‌ک	Müzik
می‌سیر	Mısır
ما‌سا‌ل	Masal
ما‌ر‌تی	Martı
مو‌لا	Mola
م‌یه‌دا‌ن	Meydan
می‌س‌ک‌ت	Misket
ما‌حا‌له	Mahalle
م‌ردی‌ون	Merdiven
ما‌کا‌ر‌نا	Makarna
مو‌ت‌لو‌لوک	Mutluluk
م‌و‌ج‌ده	Müjde
ما‌ن‌زا‌را	Manzara
ما‌رو‌ل	Marul
م‌شه	Meşe
م‌ن‌ک‌شه	Menekşe
ما‌سا‌او‌س‌تو	Masaüstü
می‌ن‌در	Minder
م‌ش‌غول	Meşgul
ما‌زو‌ت	Mazot
ما‌ن‌تار	Mantar
می‌کرو‌فو‌ن	Mikrofon
مو‌بی‌ل	Mobil
مو‌دل	Model
مو‌تی‌وا‌سیو‌ن	Motivasyon
ما‌ل‌ز‌مه	Malzeme
ما‌د‌ن	Maden
می‌ک‌نا‌تیس	Mıknatıs
م‌رحمت	Merhamet
م‌رکز	Merkez
ما‌ح‌ک‌مه	Mahkeme
ما‌ک‌یا‌ج	Makyaj
مو‌جیزه	Mucize
مو‌م‌مولوک	Mumluk
م‌ه‌ندس	Mühendis
ما‌ک‌بو‌ز	Makbuz
م‌دیا	Medya
م‌لو‌دی	Melodi
م‌و‌زی‌س‌ین	Müzisyen
ما‌س‌که	Maske
مو‌تور	Motor
ما‌ح‌سور	Mahsur
ما‌ک‌ینه	Makine
ما‌زلو‌م	Mazlum
م‌و‌سا‌یت	Müsait
ما‌ک‌یا‌و‌لیس‌ت	Makyavelist
می‌سیو‌ن	Misyon
ما‌د‌نی	Madenî
می‌س‌کین	Miskin
ما‌ت‌کا‌پ	Matkap
م‌تین	Metin
م‌تو‌ت	Metot
م‌یه‌ی‌لی	Meyilli
م‌زون	Mezun
م‌زا‌ر‌لیق	Mezarlık
م‌کا‌نیز‌ما	Mekanizma
م‌وضوع	Mevzu
م‌و‌قی	Mevki
م‌و‌ختار	Muhtar
مو‌تا‌با‌کا‌ت	Mutabakat
م‌و‌جا‌دله	Mücadele
م‌و‌عا‌مله	Muamele
م‌و‌را‌د	Murad
م‌و‌نا‌زا‌را	Münazara
م‌و‌ر‌ک‌ک‌پ‌چی	Mürekkepçi
ما‌ت‌ما‌تیک	Matematik
مو‌جیت	Mucit
م‌و‌ک‌م‌م‌ل	Mükemmel
م‌ک‌تب	Mektep
م‌ن‌ک‌ی‌به	Menkıbe
می‌کرو‌پ	Mikrop
ما‌س‌رف	Masraf
ما‌روز	Maruz
م‌و‌ش‌ت‌ری	Müşteri
ما‌نی‌دار	Manidar
ما‌لی‌یت	Maliyet
موجود	Mevcut
میده	Mide
می‌ل‌ت	Millet
م‌جا‌ز	Mecaz
م‌س‌لک	Meslek
م‌ت‌رو‌پول	Metropol
ما‌غ‌دور	Mağdur
ما‌غا‌زا	Mağaza
مو‌را‌ل	Moral
م‌و‌دا‌ها‌له	Müdahale
می‌کروس‌کو‌پ	Mikroskop
م‌سا‌ج	Mesaj
م‌جبو‌رن	Mecburen
م‌منون	Memnun
ما‌ها‌ر‌ت	Maharet
ما‌ک‌م	Makam
ما‌لو‌ما‌ت	Malumat
ما‌ح‌کو‌م	Mahkum
م‌ش‌رو	Meşru
م‌و‌سا‌با‌کا	Müsabaka
م‌را‌سیم	Merasim
م‌و‌حا‌تا‌پ	Muhatap
م‌سله	Mesele
م‌ن‌فا‌عا‌ت	Menfaat
می‌حرا‌پ	Mihrap
مو‌تا‌سیو‌ن	Mutasyon
ما‌لی‌کا‌نه	Malikane
می‌س‌را‌لار	Mısralar
م‌ر‌ه‌م	Merhem
می‌سیو‌نر	Misyoner
م‌ش‌غا‌له	Meşgale
م‌و‌نا‌سی‌پ	Münasip
م‌و‌ش‌ک‌یل	Müşkil
می‌ه‌نک	Mihenk
م‌و‌ن‌ز‌وی	Münzevi
مو‌وا‌ف‌فا‌ک	Muvaffak
مو‌وا‌زا‌عا	Muvazaa
م‌و‌با‌لا‌غا	Mübalağa
م‌ج‌لیس	Meclis
م‌و‌دور	Müdür
مو‌کا‌یه‌سه	Mukayese
مو‌وا‌ک‌کا‌ت	Muvakkat
مو‌ه‌ت‌م‌ل	Muhtemel
م‌و‌ن‌ف‌ری‌ت	Münfail
م‌و‌ت‌عا‌ه‌یت	Müteahhit
م‌و‌ت‌ف‌ک‌یر	Mütefekkir
مو‌کا‌و‌مه‌ت	Mukavemet
م‌و‌زا‌ک‌ر‌ه‌لی	Müzakereli
م‌و‌ه‌م‌ما‌ت	Mühimmat
م‌و‌عا‌مله‌جی	Muameleci
م‌راک‌لی	Meraklı
ما‌ح‌جو‌پ	Mahcup
م‌و‌دا‌ه‌یل	Müdahil
مو‌کا‌د‌در	Mukadder
م‌و‌ه‌ی‌به	Mevhibe
ما‌ح‌ز‌ن	Mahzen
می‌را‌س	Miras
م‌ه‌تا‌پ	Mehtap
م‌و‌حا‌بیر	Muhabir
م‌و‌ش‌فی‌ک	Müşfik
م‌و‌م‌ک‌ون	Mümkün
م‌ش‌غو‌لی‌یت	Meşguliyet
مو‌تا‌بی‌ک	Mutabık
م‌و‌ت‌ش‌ب‌س	Müteşebbis
م‌و‌ت‌عا‌ک‌ی‌ب‌ن	Müteakiben
م‌و‌لا‌کا‌ت	Mülakat
م‌و‌ف‌ر‌دا‌ت	Müfredat
م‌و‌نا‌کا‌شا	Münakaşa
مو‌کا‌ی‌یت	Mukayyet
ما‌سو‌م	Masum
م‌ن‌فور	Menfur
م‌و‌دا‌ویم	Müdavim
م‌کروه	Mekruh
می‌س‌کا‌ل	Miskal
ما‌غ‌رو‌ر	Mağrur
م‌و‌ت‌کا‌یت	Mütekait
م‌و‌س‌ت‌کایل	Müstakil
م‌و‌حا‌ک‌مه	Muhakeme
م‌ه‌م‌ت‌چی‌ک	Mehmetçik
مو‌کا‌د‌در‌لیک	Mukadderlik
م‌ه‌ها‌ز	Mehaz
م‌و‌ن‌ز‌وی‌لیک	Münzevilik
م‌و‌با‌لا‌غا‌لی	Mübalağalı
ما‌ح‌زو‌ن	Mahzun
ما‌ه‌ی‌یت	Mahiyet
م‌و‌س‌پ‌ت	Müspet
م‌زون‌یت	Mezuniyet
م‌س‌ک‌ن	Mesken
ما‌ت‌با‌عا	Matbaa
م‌و‌سا‌عه	Müsaade
م‌و‌ت‌ش‌ک‌یر	Müteşekkir
مو‌وا‌ز‌ن‌ه‌سز	Muvazenesiz
م‌و‌ز‌م‌ین	Müzmin
م‌ه‌تا‌پ‌لی	Mehtaplı
ما‌ز‌بو‌ت	Mazbut
ما‌س‌لا‌حا‌ت	Maslahat
ما‌غ‌ف‌ر‌ت	Mağfiret
م‌و‌ت‌ف‌ر‌ری‌ک	Müteferrik
مو‌تا‌سا‌وویف	Mutasavvıf
م‌و‌سا‌م‌ره	Müsamere
م‌و‌تا‌ر‌که	Mütareke
می‌س‌تیک	Mistik
م‌زورا	Mezura
ما‌ن‌دیرا	Mandıra
ما‌لی‌ک	Malik
ما‌ری‌ف‌ت	Marifet
ما‌ز‌با‌تا	Mazbata
م‌و‌حا‌س‌به	Muhasebe
م‌و‌ف‌ر‌د	Müfred
ما‌شا	Maşa
ما‌ت‌م	Matem
ما‌ن‌ش‌ت	Manşet
م‌و‌زه	Müze
م‌و‌ع‌ل‌یف	Müellif
م‌و‌ه‌بیر	Muhbir
م‌و‌ج‌ده‌جی	Müjdeci
می‌زا‌ج	Mizaç
ما‌سیف	Masif
ما‌ی‌ین	Mayın
م‌ش‌و‌ر‌ت	Meşveret
م‌و‌هو‌م	Mevhum
م‌و‌ت‌عا‌د‌دیت	Müteaddit
م‌و‌ش‌ت‌ر‌ک	Müşterek
مو‌وا‌ز‌زاف	Muvazzaf
م‌و‌ت‌ما‌دی‌ین	Mütemadiyen
م‌و‌ع‌ل‌یم	Muallim
م‌و‌نا‌سا‌ب‌ت	Münasabet
م‌و‌ن‌ت‌س‌ی‌پ	Müntesip
م‌و‌ف‌ت‌تی‌ش	Müfettiş
م‌و‌ت‌ها‌س‌س	Mütehassıs
م‌و‌پ‌ت‌له	Müptela
م‌و‌ت‌ما‌دی	Mütemadi
م‌و‌ت‌ف‌ر‌ری‌کا	Müteferrika
م‌و‌ه‌ت‌ر‌م	Muhterem
مو‌کا‌بی‌ل	Mukabil
مو‌سی‌کی	Musiki
م‌جبو‌ری	Mecburi
م‌و‌س‌ت‌شا‌ر	Müsteşar
م‌ف‌هو‌م	Mefhum
م‌و‌س‌س‌ه	Müessese
م‌و‌م‌ین	Mümin
م‌و‌ر‌ب‌یه	Mürebbiye
م‌و‌س‌ت‌م‌له‌که	Müstemleke
ما‌ه‌ی‌یت‌ی	Mahiyeti
م‌و‌زی‌کا‌ل	Müzikal
م‌و‌ل‌کی‌یه	Mülkiye
م‌و‌ک‌ل‌ف	Mükellef
ما‌سا‌ل‌سی	Masalsı
ما‌نا‌س‌تیر	Manastır
ما‌نی‌کور	Manikür
مو‌جو‌ک	Mucuk
میر‌لا‌ماک	Mırlamak
م‌ز‌بله‌لیک	Mezbelelik
م‌یه‌ها‌نه	Meyhane
م‌و‌لی‌ت	Mevlit
م‌و‌پ‌ه‌م	Müphem
ما‌نا‌لی	Manalı
م‌و‌ت‌وا‌زی	Mütevazı
م‌و‌س‌ت‌زا‌ت	Müstezat
م‌د‌نی‌یت	Medeniyet
م‌و‌حا‌لیف	Muhalif
م‌و‌ف‌ت‌ری	Müfteri
مو‌وا‌ح‌ه‌یت	Muvahhit
می‌لیس	Milis
م‌و‌زی‌ک‌س‌ل	Müziksel
م‌کیک	Mekik
می‌ح‌لا‌ماک	Mıhlamak
م‌ج‌زو‌پ	Meczup
ما‌سوز	Masöz
می‌نیا‌تور	Minyatür
م‌و‌ت‌ش‌ک‌ول	Müteşekkül
ما‌حا‌له‌لی	Mahalleli
م‌و‌ف‌ر‌زه	Müfreze
می‌را‌س‌چی	Mirasçı
ما‌ح‌مو‌ر	Mahmur
ما‌غا‌را	Mağara
م‌را‌سیم‌لی	Merasimli
م‌و‌س‌و‌د‌ه	Müsvedde
م‌و‌س‌یر	Müessir
م‌جا‌زی	Mecazi
م‌و‌ت‌کا‌ید	Mütekaid
م‌و‌س‌ریف	Müsrif
م‌ر‌بو‌ت	Merbut
م‌و‌نا‌جا‌ت	Münacat
م‌و‌ت‌جا‌س‌س	Mütecessis
ما‌ح‌ر‌م	Mahrem
م‌و‌س‌لو‌ما‌ن	Müslüman
می‌لیا‌رد‌ر	Milyarder
مو‌م‌یا‌لا‌ماک	Mumyalamak
مو‌عا‌فی‌یت	Muafiyet
م‌ر‌ها‌له	Merhale
ما‌ه‌ی‌یت‌لی	Mahiyetli
م‌و‌حا‌ب‌ب‌ت	Muhabbet
م‌یو‌س	Meyus
م‌ش‌عا‌له	Meşale
م‌رام	Meram
ما‌ز‌ها‌ر	Mazhar
م‌و‌ت‌عا‌ه‌یت‌لیک	Müteahhitlik
م‌و‌ک‌م‌م‌لی‌یت	Mükemmeliyet
مو‌وا‌ف‌فا‌ک‌ی‌یت	Muvaffakiyet
م‌و‌هو‌م‌یت	Mevhumiyet
م‌و‌ت‌ف‌ک‌یر‌لیک	Mütefekkirlik
م‌و‌شا‌و‌یر‌لیک	Müşavirlik
م‌و‌ع‌ی‌ی‌ده	Müeyyide
م‌و‌ش‌ک‌ول‌پ‌س‌نت	Müşkülpesent
ما‌ح‌جو‌ب‌یت	Mahcubiyet
م‌ک‌تب‌لی	Mektepli
م‌و‌ج‌ل‌یت	Mücellit
ما‌زو‌ت‌چو	Mazotçu
مو‌ختار‌لیک	Muhtarlık
م‌و‌زا‌ی‌ه‌د‌جی	Müzayedeci
ما‌ن‌تار‌جی	Mantarcı
مو‌را‌ل‌جی	Moralci
م‌ک‌تو‌پ‌چو	Mektupçu
نا‌ما‌ز	namaz
نا‌م‌لو	namlu
نا‌مو‌س	namus
نا‌م‌ز‌ت	namzet
نا‌ر	nar
نا‌رین	narin
نا‌سیل	nasıl
نا‌سی‌پ	nasip
نا‌س‌کی	naskî
نا‌تور‌ل	natürel
نا‌ی‌لو‌ن	naylon
نا‌ز	naz
نا‌زا‌ر	nazar
نا‌زی‌ک	nazik
نا‌ز‌لی	nazlı
نا‌غ‌مه	nağme
ن‌ه‌با‌ت	nebat
ن‌ه‌جا‌ت	necat
ن‌ه‌د‌ن	neden
ن‌ه‌ف‌ر	nefer
ن‌ه‌فی‌س	nefis
ن‌ه‌ف‌ر‌ت	nefret
ن‌ه‌ف‌س	nefes
ن‌ه‌یر	nehir
ن‌ه‌ر‌ی	nehrî
ن‌ه‌کی	neki
ن‌ک‌تا‌ر	nektar
ن‌م	nem
ن‌م‌لی	nemli
ن‌ه‌و‌ن	neon
ن‌شه	neşe
ن‌شه‌لی	neşeli
ن‌ت	net
ن‌ت‌لیک	netlik
ن‌و‌رو‌ز	nevroz
ن‌ه‌ی	ney
ن‌ه‌ی‌ز‌ن	neyzen
ن‌زا‌ک‌ت	nezaket
ن‌زی‌ح	nezih
ن‌ز‌له	nezle
نی‌چین	niçin
نی‌جه	nice
نی‌ها‌ت	nihat
نی‌کا‌ح	nikah
نی‌کا‌ح‌لی	nikâhlı
نی‌کا‌ح‌سز	nikâhsız
نی‌م‌ت	nimet
نی‌سا‌ن	nisan
نی‌س‌پ‌ت	nispet
نی‌س‌پ‌ت‌ن	nispeten
نی‌ت‌لی‌ک	nitelik
نی‌ت‌ه‌ک‌یم	nitekim
نی‌ت‌لی‌ک‌لی	nitelikli
نی‌ت‌لی‌ک‌سز	niteliksiz
نی‌یا‌ز	niyaz
نی‌ی‌ت	niyet
نی‌ی‌ت‌سز	niyetsiz
نی‌زا‌می	nizami
نی‌زا‌م‌لی	nizamlı
نی‌زا‌م	nizam
نی‌زا‌م‌سز	nizamsız
نی‌شا‌ن	nişan
نی‌شا‌ن‌جی	nişancı
نی‌شا‌ن‌لی	nişanlı
نی‌شا‌س‌تا	nişasta
نی‌شا‌س‌تا‌لی	nişastalı
نی‌ی‌ت‌لی	niyetli
نی‌زا‌م‌نا‌مه	nizamname
نو‌هو‌ت	nohut
نو‌ک‌تا	nokta
نو‌ک‌تا‌لا‌ما	noktalama
نو‌ک‌تا‌لی	noktalı
نو‌ر‌ما‌ل	normal
نو‌ر‌ما‌تی‌ف	normatif
نو‌ت	not
نو‌ت‌ر	nötr
نو‌ت‌لوک	notluk
نو‌ب‌ت	nöbet
نو‌ب‌ت‌چی	nöbetçi
نو‌رو‌لو‌گ	nörolog
نو‌ک‌ل‌ه‌ر	nükleer
نو‌فو‌س	nüfus
نو‌ک‌ت‌ه‌دا‌ن	nüktedan
نو‌شا	nüsha
نو‌شا‌جی	nüshacı
نو‌و‌ه‌لیک	nüvelik
نو‌زو‌ل	nüzul
نا‌رین‌لیک	narinlik
نا‌سیر‌لی	nasırlı
نا‌ز‌لا‌ن‌ماک	nazlanmak
نا‌ز‌لا‌ن‌ما	nazlanma
نا‌زا‌ر‌لیک	nazarlık
نا‌زا‌ر‌غا‌ه	nazargah
نا‌زی‌ل‌لی	nazilli
نا‌ن‌کور	nankör
نا‌ن‌کور‌لوک	nankörlük
نا‌م‌رت	namert
نا‌م‌رت‌لیک	namertlik
نا‌ما‌ز‌لیک	namazlık
نا‌رین‌لش‌مک	narinleşmek
نا‌م‌ز‌ت‌لیک	namzetlik
نا‌تور‌ا‌لیس‌ت	natüralist
نا‌کیش	nakış
نا‌کیش‌چی	nakışçı
نا‌کیش‌لی	nakışlı
نا‌ک‌لن	naklen
نا‌ک‌ل‌ت‌مک	nakletmek
نا‌ک‌لی‌یه	nakliye
نا‌ک‌لی‌یه‌جی	nakliyeci
نا‌کیش‌ها‌نه	nakışhane
نا‌دا‌س	nadas
نا‌دا‌س‌لی	nadaslı
نا‌کا‌را‌ت	nakarat
نا‌ل	nal
نا‌ل‌بو‌ر	nalbur
نا‌ل‌لا‌ماک	nallamak
نا‌ل‌لار	nallar
نا‌ل‌لی	nallı
نا‌ما‌ز‌غا‌ه	namazgah
نا‌ما‌ز‌سز	namazsız
نا‌ی‌لو‌ن‌سز	naylonsuz
نا‌زی‌ک‌جه	nazikçe
نا‌زی‌ک‌لش‌مک	nazikleşmek
نا‌ز‌لا‌نیش	nazlanış
نا‌ز‌سز	nazsız
نا‌زا‌ر‌لا‌ماک	nazarlamak
نا‌ز‌لا‌نی‌ور‌مک	nazlanıvermek
ن‌زا‌ک‌ت‌سز	nezaketsiz
ن‌زا‌ک‌ت‌سز‌لیک	nezaketsizlik
ن‌س‌یل	nesil
ن‌س‌یل‌لر	nesiller
ن‌س‌لی	nesli
ن‌س‌ن‌ل‌لیک	nesnellik
ن‌س‌نه	nesne
ن‌تی‌جه	netice
ن‌تی‌جه‌لن‌در‌مک	neticeleştirmek
ن‌تی‌جه‌لن‌مک	neticeleşmek
ن‌و‌ر‌س‌یم	nevresim
ن‌زا‌ک‌ت‌لی	nezaketli
ن‌زا‌ک‌ت‌لی‌جه	nezaketlice
ن‌زی‌ح‌لیک	nezihlik
ن‌زی‌ح‌جه	nezihçe
ن‌زا‌ک‌ت‌لی‌لیک	nezaketlilik
نی‌دا	nida
نی‌دا‌لا‌ن‌ماک	nidalanmak
نی‌دا‌لا‌نیش	nidalanış
نی‌دا‌لا‌نی‌ور‌مک	nidalanıvermek
نی‌غا‌ر	nigar
نی‌ها‌ی	nihai
نی‌ها‌ی‌ت	nihayet
نی‌ها‌ی‌ت‌ن‌ده	nihayetinde
نی‌ها‌ن	nihan
نی‌ها‌ن‌لیک	nihanlık
نی‌م‌ت‌سز	nimetsiz
نی‌س‌یل	nispî
نی‌س‌یل‌لیک	nispîlik
نی‌شا‌ن‌جی‌با‌شی	nişancıbaşı
نی‌شا‌ن‌لا‌ماک	nişanlamak
نی‌شا‌ن‌لا‌ن‌ماک	nişanlanmak
نی‌شا‌ن‌لی‌لیک	nişanlılık
نی‌شا‌ن‌سز	nişansız
نی‌شا‌ن‌غا‌ه	nişangah
نی‌ت‌لی‌ک‌س‌ل‌لیک	niteliksellik
نی‌ت‌لی‌ک‌سز‌لش‌مک	niteliksizleşmek
نی‌ت‌ل‌ی‌جی	niteleyici
نی‌ت‌لن‌مک	nitelenmek
نی‌ت‌لن‌در‌مک	nitelendirmek
نی‌ت‌لی‌ک‌سز‌لیک	niteliksizlik
نی‌زا‌م‌یه	nizamiye
نی‌زا‌م‌سز‌لیک	nizamsızlık
نی‌زا‌م‌لا‌ماک	nizamlamak
نو‌هو‌ت‌لو	nohutlu
نو‌ک‌تا‌سز	noktasız
نو‌ک‌تا‌لی‌ویر‌گول	noktalıvirgül
نو‌ر‌م‌سز	normsuz
نو‌ت‌لا‌ن‌در‌ماک	notlandırmak
نو‌ت‌لا‌ن‌ماک	notlanmak
نو‌ب‌ت‌چی‌لیک	nöbetçilik
نو‌ب‌ت‌لش‌مک	nöbetleşmek
نو‌رو‌پ‌سی‌کولو‌ژی	nöropsikoloji
نو‌ت‌ر‌لش‌مک	nötrleşmek
نو‌ک‌ته	nükte
نو‌ک‌ت‌لی	nükteli
نو‌ک‌ت‌سز	nüktesiz
نو‌شا‌سز	nüshasız
نو‌وه	nüve
نو‌و‌لن‌مک	nüvelenmek
نو‌و‌لن‌مه	nüvelenme
نو‌و‌لش‌مک	nüveleşmek
نو‌و‌لش‌مه	nüveleşme
نو‌فو‌س‌لو	nüfuslu
نو‌فو‌ز	nüfuz
نو‌فو‌ز‌لو	nüfuzlu
نو‌فو‌ز‌سز	nüfuzsuz
نو‌فو‌ز‌سز‌لوک	nüfuzsuzluk
نا‌ک‌لی‌یا‌ت	nakliyat
ن‌ف‌س‌لیک	nefeslik
ن‌ف‌س‌لن‌مک	nefeslenmek
ن‌شه‌لن‌مک	neşelenmek
نی‌ی‌ت‌لن‌مک	niyetlenmek
نی‌ی‌ت‌لی‌لیک	niyetlilik
نی‌شا‌ن‌لیک	nişanlık
نو‌ر‌لا‌ن‌ماک	nurlanmak
نو‌ر‌لو	nurlu
نو‌فو‌س‌لوک	nüfusluk
نو‌فو‌ز‌ا‌ت‌مک	nüfuz etmek
نو‌مو‌نه	numune
نو‌ما‌را‌لا‌ن‌در‌ماک	numaralandırmak
نا‌رین‌لش‌مه	narinleşme
نی‌یا‌ز‌ا‌ت‌مک	niyaz etmek
نو‌ما‌را‌جی	numaracı
نو‌ب‌ت‌لشه	nöbetleşe
نو‌ت‌ر‌لش‌تر‌مک	nötrleştirmek
نو‌ه‌ب‌ت	nuhbet
نا‌نه‌ش‌ک‌ری	nane şekeri
نا‌سیر‌لا‌ن‌ماک	nasırlanmak
نا‌سی‌حا‌ت‌نا‌مه	nasihatname
نا‌زا‌ری‌یا‌ت	nazariyat
نا‌رین‌لیک‌ت‌ن	narinlikten
نا‌رین‌لش‌میش	narinleşmiş
نی‌ت‌لی‌ک‌س‌ل	niteliksel
اولا	ola
اولا‌جا‌ک	olacak
اولا‌ی	olay
اول‌گو‌ن	olgun
اول‌گو‌ن‌لوک	olgunluk
اول‌ماک	olmak
اول‌ما‌ز	olmaz
اولو‌م‌سز	olumsuz
اولو‌م	ölüm
اولو‌م‌لو	ölümlü
اولو‌ن	olun
اولو‌ن‌ما‌ز	olunmaz
اولو‌ن‌ماک	olunmak
اولو‌پ	olup
اولو‌ر	olur
اولو‌ر‌سا	olursa
اولو‌ش	oluş
اولو‌ش‌ماک	oluşmak
اولو‌شو‌م	oluşum
اولو‌ش‌تور‌ماک	oluşturmak
اولو‌م‌سال	olumsal
او‌مو‌ز	umuz
او‌ن	Ün
او‌نا	una
او‌نا‌ی	onay
او‌نا‌ی‌لا‌ماک	onaylamak
او‌نا‌ی‌لا‌ن‌ماک	onaylanmak
او‌ن‌دا‌لیک	ondalık
او‌ن‌سز	Ünsüz
او‌ن‌تو‌لو‌ژی	ontoloji
او‌پو‌زی‌سیو‌ن	opozisyon
او‌را‌ن	oran
او‌ر‌گا‌ن	organ
او‌ر‌گا‌نی‌ک	organik
او‌ر‌گا‌نی‌زا‌سیو‌ن	organizasyon
او‌ر‌گا‌ز‌م	orgazm
او‌ری‌جین	orijin
او‌ر‌ک‌س‌ترا	orkestra
او‌ر‌تا‌لا‌ما	ortalama
او‌ر‌تا‌لیک	ortalık
او‌ر‌تا‌ک	ortak
او‌ر‌تا‌ک‌لیک	ortaklık
او‌ر‌تا‌م	ortam
او‌ر‌تا	orta
او‌رو‌جو	orucu
او‌رو‌چ	oruç
او‌س‌ما‌ن‌لی	osmanlı
او‌س‌ما‌ن‌لی‌جه	osmanlıca
او‌تو‌ما‌ت	otomat
او‌تو‌ما‌تی‌ک	otomatik
او‌تو‌مو‌بی‌ل	otomobil
او‌تو	oto
او‌تو‌بو‌س	otobüs
او‌تو‌ک‌را‌ت	otokrat
او‌تو‌ک‌را‌سی	otokrasi
او‌تو‌ک‌را‌تی‌ک	otokratik
او‌تو‌پ‌سی	otopsi
او‌تو‌ری‌ته	otorite
او‌تو‌ری‌ت‌ر	otoriter
او‌تو‌س‌تو‌پ	otostop
او‌تور‌ما	oturma
او‌تور‌ماک	oturmak
او‌تور‌ت‌ماک	oturtmak
او‌تو‌ز	otuz
او‌وا	ova
او‌یا‌لا‌ماک	oyalamak
او‌ی‌ماک	oymak
او‌ی‌نا‌ک	oynak
او‌یو‌ن	oyun
او‌یو‌ن‌جو	oyuncu
او‌یو‌ن‌جو‌لوک	oyunculuk
او‌یو‌ن‌با‌ز	oyunbaz
او‌یو‌ن‌بو‌زا‌ن	oyunbozan
او‌زا‌ن	ozan
او‌زو‌ن	ozon
او‌زو	ozu
او‌ب‌جه	obje
او‌ب‌جه‌تی‌ف	objektif
او‌ب‌رو‌ک	obruk
او‌ب‌س‌ه‌سیو‌ن	obsesyon
او‌ب‌سی‌دا‌ن	obsidan
او‌بو‌ر	obur
او‌جا‌ک	ocak
او‌غو‌ل	oğul
او‌غو‌ل‌لوک	oğulluk
او‌غ‌لا‌ن	oğlan
او‌غ‌لا‌ن‌جه	oğlanca
او‌غ‌لا‌ن‌لیک	oğlanlık
او‌غو‌ل‌لا‌ش‌ما	oğullaşma
او‌دا	oda
او‌دا‌لیک	odalık
او‌دو‌ن	odun
او‌دو‌ن‌لوک	odunluk
او‌دو‌ر	odur
او‌فا‌ن‌سی‌ف	ofansif
او‌فی‌س	ofis
او‌فی‌س‌ر	ofiser
او‌فی‌س‌ر‌لیک	ofiserlik
او‌فی‌س‌یا‌ن	ofisyan
او‌ف‌س‌ت	ofset
او‌ف‌تا‌لی	oftalı
او‌ف‌سا‌یت	ofsayt
او‌ها‌ل	ohal
او‌ها‌ی	ohay
او‌ها‌ل‌ت	ohalet
او‌ک	ok
او‌کا‌نا‌ل	okanal
او‌ک‌ه‌ی	okey
او‌ک‌کا‌لی	okkalı
او‌ک‌لا‌ماک	oklamak
او‌ک‌ماک	okmak
او‌ک‌شا‌ماک	okşamak
او‌ک‌تا‌ی	oktay
او‌ک‌تا‌ی‌لیک	oktaylık
او‌کو‌ل	okul
او‌کو‌ما	okuma
او‌کو‌یو‌جو	okuyucu
او‌کو‌یو‌جو‌لوک	okuyuculuk
او‌کو‌ر‌یا‌زا‌ر	okuryazar
او‌کو‌ر‌یا‌زا‌ر‌لیک	okuryazarlık
اولا‌غا‌ن	olağan
اولا‌غا‌ن‌او‌س‌تو	olağanüstü
اولا‌بی‌ل‌دی‌گی‌ن‌جه	olabildiğince
اولا‌بی‌ل‌ه‌ج‌ک	olabilecek
اولا‌بی‌لیر	olabilir
اولا‌ما‌ز	olamaz
اولا‌ما‌ز‌لیک	olamazlık
اولا‌ی‌جی	olaycı
اولا‌ی‌لار	olaylar
اولا‌ی‌لی	olaylı
اولا‌ی‌سز	olaysız
اولا‌را‌ک	olarak
اولا‌سی	olası
اولا‌سی‌لیک	olasılık
اول‌دو	oldu
اول‌دو‌ک‌چه	oldukça
اول‌دو‌غو	olduğu
اول‌گو‌ن‌لا‌ش‌ماک	olgunlaşmak
اول‌گو‌ن‌لا‌ش‌تر‌ماک	olgunlaştırmak
اولو‌م‌سز‌لوک	olumsuzluk
اولو‌م‌لا‌ما	olumlama
او‌م‌بو‌د‌س‌ما‌ن	ombudsman
او‌م‌جه	omca
او‌می‌ک‌رو‌ن	omikron
او‌مو‌ز‌دا‌ش	omuzdaş
او‌مو‌ز‌لا‌ماک	omuzlamak
او‌مو‌ر‌غا	omurga
او‌ن‌دا‌ن	ondan
او‌ن‌د‌سز	ondsuz
او‌ن‌ر	oner
او‌ن‌ر‌مه	önerme
او‌ن‌لار	onlar
او‌ن‌لوک	onluk
او‌نو‌ر	onur
او‌نو‌ر‌لو	onurlu
او‌نو‌ر‌سز	onursuz
او‌پا‌لو‌ید	opaloid
او‌پا‌ک	opak
او‌پا‌ر	opar
او‌پ‌را‌سیو‌ن	operasyon
او‌پ‌را‌تور	operatör
او‌پ‌ر‌ت	operet
او‌پ‌ی‌نیو‌ن	opinion
او‌پ‌یو‌م	opium
او‌را‌ن‌لی	oranlı
او‌را‌ن‌لا‌ماک	oranlamak
او‌ر‌گو	örgü
او‌ر‌جین	orjin
او‌ر‌لوک	orluk
او‌ر‌ما‌ن	orman
او‌ر‌ما‌ن‌لیک	ormanlık
او‌ر‌ما‌ن‌لی	ormanlı
او‌رو‌چ‌لو	oruçlu
او‌رو‌چ‌سز	oruçsuz
او‌رو‌چ‌تو‌ت‌ماک	oruç tutmak
او‌تا‌ما‌ت	otamat
او‌تا‌ما‌تی‌ک	otamatik
او‌یا‌لا‌ن‌ماک	oyalanmak
او‌ی‌ما‌ک‌لیک	oymaklık
او‌ی‌نا‌ک‌لیک	oynaklık
او‌یو‌ن‌لوک	oyunluk
او‌یو‌ن‌ماک	oyunmak
او‌زا‌ن‌لیک	ozanlık
او‌زو‌ن‌لا‌ما	ozonlama
او‌ن‌م	önem
او‌ن‌م‌سز	önemsiz
او‌ن‌ج‌لی‌ک	öncelik
او‌ن‌جو‌ل	öncül
او‌ن‌در	önder
او‌ن‌گو‌رو	öngörü
او‌غ‌ر‌ن‌مک	öğrenmek
او‌غ‌ر‌ن‌جی	öğrenci
او‌غ‌ر‌ت‌م‌ن	öğretmen
او‌غ‌ر‌ت‌مک	öğretmek
او‌غو‌ت	öğüt
او‌غو‌ت‌لمک	öğütlemek
او‌غو‌ت‌ور‌مک	öğüt vermek
او‌غو‌ن	öğün
او‌غو‌ن‌مک	öğünmek
اول‌چ‌مک	ölçmek
اول‌چو‌م	ölçüm
اول‌چو‌سز	ölçüsüz
اول‌چو	ölçü
اولو‌ن‌چ	ölünç
اول‌مک	ölmek
اومو‌ر	ömür
اومو‌ر‌لوک	ömürlük
او‌نا‌یا‌ک	önayak
او‌نا‌یا‌ک‌لیک	önayaklık
او‌ن‌م‌س‌مک	önemsemek
او‌ن‌م‌س‌ی‌یش	önemseyiş
او‌ن‌م‌سز‌لش‌مک	önemsizleşmek
او‌ن‌ده‌گ‌ل‌ن	önde gelen
او‌ن‌د‌ن‌گ‌یت‌مک	önden gitmek
او‌ن‌ری	öneri
او‌ن‌ر‌گه	önerge
او‌ن‌ر‌یل‌مک	önerilmek
او‌ن‌گو‌ر‌مک	öngörmek
او‌ن‌گو‌رو‌ش	öngörüş
او‌ن‌گو‌رو‌لو	öngörülü
او‌ن‌یا‌ر‌غی	önyargı
او‌ن‌یا‌ر‌غی‌لی	önyargılı
او‌پ‌ه‌جیک	öpecik
او‌پ‌ر	öper
او‌پ‌مک	öpmek
او‌پو‌ش‌مک	öpüşmek
او‌پ‌تور‌مک	öptürmek
او‌ر‌گو‌ت	örgüt
او‌ر‌گو‌ت‌لمک	örgütlemek
او‌ر‌گو‌ت‌ل‌ن‌مک	örgütlenmek
او‌ر‌گو‌ت‌ل‌نیش	örgütleniş
او‌ر‌گو‌ت‌لو	örgütlü
او‌ر‌گو‌جو	örgücü
او‌ر‌گو‌لو	örgülü
او‌ر‌ن‌ک	örnek
او‌ر‌ن‌ک‌لمک	örneklemek
او‌ر‌ن‌ک‌ل‌ن‌مک	örneklenmek
او‌ر‌ن‌ک‌لی	örnekli
او‌ر‌س‌ل‌ن‌مک	örselenmek
او‌ر‌س‌ل	örsel
او‌ر‌ت‌با‌س	örtbas
او‌ر‌ت‌مک	örtlemek
او‌ر‌تو‌لو	örtülü
او‌ر‌تو‌سز	örtüsüz
او‌ر‌تو	örtü
او‌ت‌ه‌س‌ن‌ده	ötesinde
او‌ت‌ه‌کی	öteki
او‌ت‌ه‌ل‌مک	ötelemek
او‌ت‌ه‌سی	ötesi
او‌ت‌مک	ötmek
او‌تو‌جو	ötücü
او‌و‌گو	övgü
او‌و‌مک	övmek
او‌ز‌ن	özen
او‌ز‌ن‌له	özenle
او‌ز‌ن‌مک	özenmek
او‌ز‌ن‌سز	özensiz
او‌ز‌گو	özgü
او‌ز‌گو‌ر	özgür
او‌ز‌گو‌ر‌لوک	özgürlük
او‌ز‌ل‌مک	özlemek
او‌ز‌ل‌م	özlem
او‌ز‌لو	özlü
او‌ز‌لوک	özlük
او‌ز‌ن‌ل	öznel
او‌ز‌نه	özne
او‌ز‌ن‌ل‌لیک	öznellik
او‌ز‌و‌ری	özveri
او‌ز‌و‌ری‌لی	özverili
او‌زو‌ر	özür
او‌زو‌ر‌لو	özürlü
او‌زو‌ر‌دی‌ل‌مک	özür dilemek
او‌ز‌د‌ی‌یش	özdeyiş
او‌ز‌ر‌ک	özerk
او‌ز‌ت	özet
او‌ز‌ت‌لمک	özetlemek
او‌ز‌ت‌ل‌ن‌مک	özetlenmek
او‌ز‌گو‌ر‌لوک‌چو	özgürlükçü
او‌ز‌ه‌ل‌لش‌تر‌مک	özelleştirmek
او‌ز‌ه‌ل‌لش‌مک	özelleşmek
او‌ز‌ه‌ل‌لیک	özellik
او‌ز‌د‌یش‌لیک	özdeşlik
او‌ز‌د‌ش	özdeş
او‌ز‌گو‌ر‌لوک‌چو‌لوک	özgürlükçülük
او‌ن‌یا‌ر‌غی‌سز	önyargısız
او‌زو‌م‌س‌مک	özümsemek
او‌زو‌م‌س‌ی‌یش	özümseyiş
او‌زو‌م‌ل‌مه	özümleme
او‌زو‌م‌ل‌مک	özümlemek
او‌زو‌م‌س‌ر‌لیک	özümserlik
او‌زو‌م	özüm
او‌زو‌م‌س‌مه	özümseme
او‌ز‌ل‌ش‌مه	özleşme
او‌ز‌د‌ش‌لش‌مک	özdeşleşmek
او‌ز‌گو‌ن‌لوک	özgünlük
او‌و‌گو‌دو‌لو	övgü dolu
او‌ز‌گو‌و‌ن	özgüven
را‌بیتا	rabıta
ر‌ه‌م‌ت	rahmet
ر‌یزا	rıza
ر‌ید‌وان	rıdvan
رو‌یا	rüya
رو‌ت‌به	rütbe
رو‌ش‌و‌ت	rüşvet
رو‌ش‌تی‌ه	rüştiye
رو‌چ‌هان	rüçhan
را‌ک‌یبه	rakıbe
ر‌ه‌کا‌ب‌ت	rekabet
ر‌یف‌ک	rıfk
را‌ه‌ات	rahat
را‌ه‌یبه	rahibe
را‌ه‌مان	rahman
را‌ه‌مانی	rahmanî
را‌هیم	rahîm
را‌وی	ravi
رو‌کو	rüku
ر‌یز‌یق	rızık
ر‌یه‌له	rıhle
ر‌یدا	rida
رو‌ح	ruh
رو‌هانی	ruhani
رو‌ه‌سا‌ت	ruhsat
رو‌سوم	rüsum
رو‌کون	rükün
ر‌ه‌سول	resul
رو‌کوع	rükû
ر‌ی	rey
ر‌ی‌جا‌ت	ricat
ر‌ه‌د‌ی‌ه	reddiye
ر‌ج‌م	recm
ر‌ه‌سیم	resim
ر‌ه‌سیم‌لی	resimli
رو‌فا‌عیل‌یک	rüfailik
ر‌ین‌د	rind
ر‌ین‌دا‌نه	rindane
ر‌یه‌تیم	rıhtım
ر‌ه‌عا‌یا	reaya
ر‌ی‌با‌ت	ribat
ر‌ی‌با‌ت‌چی	ribatçı
رو‌سوما‌ت	rüsumat
رو‌ک‌ن‌ت‌دین	rüknettin
رو‌ک‌ن‌ل‌م‌س‌ل‌م‌ین	rüknülmüslimin
ر‌ه‌وا	reva
ر‌ی‌با‌ت‌لی	ribatlı
ر‌ه‌له	rahle
را‌ما‌ضا‌ن	ramazan
ر‌ه‌کا‌ت	rekat
ر‌ه‌ب‌ر	rehber
ر‌ه‌هین	rehin
ر‌ه‌سول‌الله	resulullah
ر‌یف‌کی	rıfkı
ر‌ی‌فا‌ت	rifat
را‌ه‌م‌ت‌لی	rahmetli
را‌ه‌ا‌ت‌سز	rahatsız
را‌ک‌یک	rakik
را‌ک‌یم	rakım
را‌کا‌م	rakam
ر‌ه‌س‌م‌ی‌ی‌ت	resmiyet
ر‌ه‌س‌می	resmi
رو‌یایی	rüyaî
رو‌ی‌ه‌ت	rüyet
رو‌یا‌او‌س‌تو	rüyaüstü
رو‌ه‌ن	ruhen
رو‌ه‌لو	ruhlu
رو‌ه‌سز	ruhsuz
رو‌ه‌ی‌ی‌ه	ruhiyye
رو‌ه‌ی‌ا‌ت	ruhiyat
رو‌ه‌سا‌ت‌نا‌مه	ruhsatname
رو‌ه‌نو‌ما	ruhnüma
رو‌یا‌جی	rüyacı
رو‌یا‌پ‌ر‌ه‌س‌ت	rüyaperest
ر‌ه‌چ‌ه‌ته	reçete
ر‌ه‌چ‌ه‌ت‌لی	reçeteli
ر‌ه‌چ‌ه‌ت‌سز	reçetesiz
ر‌ه‌واک	revak
ر‌ه‌و‌ناک	revnak
ر‌ه‌واچ	revaç
ر‌ه‌واچ‌تا	revaçta
ر‌ه‌واچ‌سز	revaçsız
ر‌ی‌ه‌ان	reyhan
ر‌ی‌ه‌ا‌نه	reyhane
ر‌یزا‌ه‌ن‌لله	rızaenillah
ر‌یزا‌الله	rızaullah
ر‌یزا‌لیک	rızalık
ر‌یزا‌ه‌ه‌لی	rızaehli
ر‌یز‌ک‌لله	rızkullah
ر‌یز‌ک	rızk
ر‌یز‌یق‌چی	rızıkçı
ر‌یز‌یق‌لان‌ماک	rızıklanmak
ر‌یز‌یق‌لان‌د‌ر‌ماک	rızıklandırmak
ر‌یز‌ک‌ه‌ه‌لال	rızkıhelal
ر‌یزا‌سز	rızasız
ر‌یزا‌کا‌ر	rızakar
ر‌یف‌ک‌لله	rıfkullâh
ر‌یف‌ک‌م‌ن‌زیل	rıfkımenzil
ر‌یک‌کا‌ت	rikkat
ر‌یک‌کا‌ت‌لی	rikkatli
ر‌یک‌کا‌ت‌سز	rikkatsiz
ر‌ی‌یا‌کا‌ر	riyakâr
ر‌ی‌یا‌دا‌ن	riyadan
ر‌ی‌یا‌زا‌ت	riyazat
ر‌ی‌یا‌ز‌ی‌ی‌ه	riyaziyye
ر‌ی‌یا‌زی	riyazî
ر‌ی‌یا‌ز‌یا‌ت	riyaziyât
رو‌س‌وا	rüsva
رو‌س‌وا‌ی	rüsvay
رو‌س‌وا‌ی‌لیک	rüsvaylık
رو‌یا‌ه‌ه‌لی	rüyaehli
را‌هیم‌ی	rahimî
را‌ه‌م‌ت‌کا‌ر	rahmetkâr
را‌ه‌م‌ت‌الله	rahmetullah
را‌ه‌م‌تا‌نه	rahmetâne
را‌ه‌م‌ت‌ه‌نه	rahmethane
را‌ه‌م‌ت‌نا‌زیر	rahmetnazır
را‌ه‌م‌ت‌نا‌ز	rahmetnaz
ر‌ه‌س‌م‌لله	resmullah
ر‌ه‌سول‌ی	resulî
ر‌ه‌سول‌الله‌ی	resulullahî
ر‌ه‌سول‌ی‌ی‌ت	resuliyet
رو‌ک‌نی	rüknî
ر‌ه‌عا‌یایی	reayaî
ر‌ه‌ف‌ت	refet
ر‌ه‌ف‌ت‌لی	re'fetli
ر‌ه‌فا‌ه	refah
ر‌ه‌ف‌یکا	refika
ر‌ه‌ف‌یک	refik
ر‌ه‌ف‌یکا‌نه	refikane
ر‌ه‌ف‌یک‌لله	refikullah
ر‌ه‌ف‌یک‌ی‌ی‌ت	refikiyet
ر‌ه‌فور‌م	reform
ر‌ه‌فور‌م‌جو	reformcu
ر‌ه‌فور‌م‌ی‌س‌ت	reformist
ر‌ه‌فا‌کا‌ت	refakat
ر‌ه‌فا‌کا‌ت‌چی	refakatçi
ر‌ه‌ف‌تا‌ر‌لیک	reftarlık
ر‌ه‌سول‌ی‌لیک	resulîlik
ر‌ه‌س‌م‌ن	resmen
رو‌ت‌به‌لی	rütbeli
رو‌ت‌به‌سز	rütbesiz
رو‌ت‌به‌لیک	rütbelik
رو‌ت‌به‌جی	rütbeci
رو‌ت‌به‌لش‌مک	rütbeleşmek
رو‌ت‌به‌لش‌تر‌مک	rütbeleştirmek
رو‌تو‌ف‌ت	rütufet
رو‌تو‌ف‌ت‌لی	rütufetli
رو‌تو‌ف‌ت‌سز	rütufetsiz
رو‌یا‌ه‌ن	rüyaen
رو‌یایی‌لیک	rüyaîlik
رو‌یایی‌لش‌مک	rüyaîleşmek
رو‌یایی‌لش‌تر‌مک	rüyaîleştirmek
رو‌یا‌چوزوم	rüyaçözüm
رو‌یا‌چوزوم‌چو‌لوک	rüyaçözümcülük
رو‌یا‌چوزوم‌چو	rüyaçözümcü
رو‌یا‌گ‌ر‌چ‌ک	rüyagerçek
رو‌یا‌گ‌ر‌چ‌ک‌لیک	rüyagerçeklik
رو‌یا‌ه‌ک‌ی‌قا‌ت	rüyahakikat
رو‌یا‌ه‌ل	rüyahal
رو‌یا‌ه‌ل‌جی	rüyahalci
رو‌یا‌نو‌فو‌ز	rüyanüfuz
رو‌یا‌ت‌ه‌ف‌س‌یر	rüyatefsir
رو‌یا‌ت‌ه‌ف‌س‌یر‌جی	rüyatefsircisi
رو‌یا‌وا‌ری	rüyavari
رو‌یا‌وا‌ر‌لیک	rüyavarlık
رو‌یا‌وا‌ر‌لی‌گی	rüyavarlığı
رو‌یا‌ش‌ینا‌س	rüyaşinas
رو‌یا‌ش‌ینا‌سی	rüyaşinasi
رو‌یا‌ش‌ینا‌س‌لیک	rüyaşinaslık
رو‌یا‌ش‌ینا‌سی‌لیک	rüyaşinasîlik
سا‌دا‌کا‌ت	sadakat
سا‌فی‌ی‌ت	safiyet
سا‌ب‌ر	sabr
سا‌عا‌ت	saat
سا‌دا‌کا	sadaka
سا‌د‌ت	sadet
سا‌د‌یق	sadık
سا‌د‌ت‌نا‌مه	sadetname
سا‌در	sadr
سا‌در‌آزا‌م	sadrâzam
سا‌فا	safa
سا‌ف‌ه‌ا	safha
سا‌ف‌کا‌ن	safkan
سا‌ف‌سا‌تا	safsata
سا‌ف	saf
سا‌ه‌ا‌به	sahabe
سا‌ه‌ا‌ف	sahaf
سا‌ه‌ا‌ن	sahan
سا‌ه‌ی‌ه	sahih
سا‌ه‌ی‌پ	sahip
سا‌ه‌را	sahra
سا‌ه‌نه	sahne
سا‌ه‌ن	sahn
سا‌عیر	sair
سا‌کا‌ل	sakal
سا‌کا‌ت	sakat
سا‌کا‌تا‌ت	sakatat
سا‌ک‌یل	sakil
سا‌ک‌ی‌ن‌ما	sakınma
سا‌ک‌لی	saklı
سا‌ک‌ی‌ن‌جا	sakınca
سا‌ک‌ی‌ن‌تی	sakıntı
سا‌ک‌ی‌ت	sakıt
سا‌لا	sala
سا‌لا‌وا‌ت	salavat
سا‌لا‌ه‌ی‌ی‌ت	salahiyet
سا‌ل‌ی‌ه	salih
سا‌ل‌یک	salik
سا‌ل‌یم	salim
سا‌ل‌ی‌سه	salise
سا‌ل‌لا‌ن‌تی	sallantı
سا‌ل‌یا‌ن‌گو‌ز	salyangoz
سا‌لو‌ن	salon
سا‌ل‌تا‌نا‌ت	saltanat
سا‌ل‌وو	salvo
سا‌م‌ی‌می	samimi
سا‌م‌ی‌م‌ی‌ی‌ت	samimiyet
سا‌م‌سو‌ن‌لو	samsunlu
سا‌نا‌ی‌ی	sanayi
سا‌نا‌ت	sanat
سا‌نا‌ت‌کا‌ر	sanatkâr
سا‌ن‌ری	sanrı
سا‌ن‌سور	sansür
سا‌ن‌ت‌یم	santim
سا‌را‌ی	saray
سا‌ر‌ف	sarf
سا‌ر‌هوش	sarhoş
سا‌ر‌ک‌ی‌ن‌تی	sarkıntı
سا‌ر‌کی	sarkı
سا‌ر‌ک‌ما	sarkma
سا‌ر‌را‌ف	sarraf
سا‌ر‌سا‌ک	sarsak
سا‌ر‌س‌ی‌ن‌تی	sarsıntı
سا‌ر‌س‌ما‌ک	sarsmak
سا‌ر‌ت	sart
سا‌ر‌ی‌ق	sarık
سا‌ر‌ی‌کا‌م‌یش	sarıkamış
سا‌ر‌ما	sarma
سا‌ر‌ما‌ل	sarmal
سا‌ر‌را‌ف‌ی‌ی‌ه	sarrafiye
سا‌ر‌س‌ی‌ل‌ما‌ک	sarsılmak
سا‌ت‌ی‌ه	satıh
سا‌ت‌ر	satır
سا‌ت‌ما‌ک	satmak
سا‌ت‌ی‌ن	satın
سا‌ت‌ی‌جی	satıcı
سا‌و	sav
سا‌وا‌ش	savaş
سا‌وا‌ش‌چی	savaşçı
سا‌و‌جی	savcı
سا‌و‌ل‌ت	savlet
سا‌و‌را‌ن	savran
سا‌و‌سا‌ک‌لا‌ما	savsaklama
سا‌ی‌فا	sayfa
سا‌ی‌غی	saygı
سا‌ی‌غی‌لی	saygılı
سا‌ی‌ه‌ا	sayha
سا‌ی‌ی	sayı
سا‌ی‌ی‌سا‌ل	sayısal
سا‌ی‌کا‌ل	saykal
سا‌ی‌ما‌ک	saymak
سا‌ی‌ما‌ن	sayman
سا‌ز	saz
س‌ه‌با‌ت	sebat
س‌ه‌ب‌ه‌پ‌سز	sebepsiz
س‌ه‌ب‌ه‌پ	sebep
س‌ه‌ب‌زه	sebze
س‌ه‌ج‌جا‌ده	seccade
س‌ه‌ج‌ی‌ی‌ه	seciye
س‌ه‌چ‌ه‌ن‌ک	seçenek
س‌ه‌چ‌یم	seçim
س‌ه‌چ‌ک‌ین	seçkin
س‌ه‌دا	seda
س‌ه‌دیر	sedir
س‌ه‌د‌ی‌ه	sedye
س‌ه‌فا	sefa
س‌ه‌فا‌ل‌ت	sefalet
س‌ه‌ف‌ر	sefer
س‌ه‌ف‌ر‌ب‌ر	seferber
س‌ه‌ف‌ر‌ب‌ر‌لیک	seferberlik
س‌ه‌فیر	sefir
س‌ه‌ف‌ی‌ه	sefih
س‌ه‌ف‌ی‌نه	sefine
س‌ه‌فیل	sefil
س‌ه‌ف‌ی‌یا‌نه	sefiyane
س‌ه‌غا‌ه	segâh
س‌ه‌ه‌پا	sehpa
س‌ه‌ه‌و‌ن	sehven
س‌ه‌هر	sehr
س‌ه‌کا	seka
س‌ه‌کا‌را‌ت	sekarat
س‌ه‌ک‌با‌ن	sekban
س‌ه‌ک‌یز	sekiz
س‌ه‌ک‌مه	sekme
س‌ه‌ک‌س‌ی‌یو‌ن	seksiyon
س‌ه‌ک‌ته	sekte
س‌ه‌کو‌لر	seküler
س‌ه‌ل	sel
س‌ه‌لا‌م	selam
س‌ه‌لا‌م‌ت	selamet
س‌ه‌لا‌م‌لیق	selamlık
س‌ه‌لا‌م‌و‌نا‌ل‌ی‌کوم	selamünaleyküm
س‌ه‌لا‌ن‌یک‌لی	selanikli
س‌ه‌لا‌ت‌ین	selatin
س‌ه‌له	sele
س‌ه‌ل‌ک	selek
س‌ه‌ل‌ک‌تور	selektör
س‌ه‌ل‌ن	selen
س‌ه‌ل‌ف‌ی‌ه	selfie
س‌ه‌ل‌یم	selim
س‌ه‌ل‌وی	selvi
س‌ه‌ما	sema
س‌ه‌ما‌وی	semavi
س‌ه‌ما‌ز‌ن	semazen
س‌ه‌م‌بول	sembol
س‌ه‌م‌ر‌جی	semerci
س‌ه‌م‌ر	semer
س‌ه‌م‌ی‌ه	semih
س‌ه‌م‌ی‌ه‌ا	semiha
س‌ه‌م‌پ‌تو‌م	semptom
س‌ه‌نا‌ر‌یو	senaryo
س‌ه‌نه	sene
س‌ه‌ن‌ه‌لیک	senelik
س‌ه‌ن‌ت	senet
س‌ه‌نیر	senir
س‌ه‌ن‌ک‌رو‌ن	senkron
س‌ه‌ن‌یور	senyor
س‌ه‌پ‌ت	sepet
س‌ه‌ر	ser
س‌ه‌را‌پ	serap
س‌ه‌ر‌ب‌ه‌س‌ت	serbest
س‌ه‌ر‌چ‌ه	serçe
س‌ه‌ر‌دا‌ر	serdar
س‌ه‌ر‌گو‌ز‌ه‌ش‌ت	sergüzeşt
س‌ه‌ر‌ه‌ا‌ت	serhat
س‌ه‌ر‌هوش	serhoş
س‌ه‌ر‌ین	serin
س‌ه‌ر‌ی‌ن‌کا‌ن‌لی	serinkanlı
س‌ه‌ر‌ما‌ی‌ه	sermaye
س‌ه‌ر‌ما‌ی‌ه‌دا‌ر	sermayedar
س‌ه‌ر‌پوش	serpuş
س‌ه‌ر‌س‌ه‌ری	serseri
س‌ه‌ر‌س‌ه‌م	sersem
س‌ه‌رو‌م	serum
س‌ه‌ر‌و‌ت	servet
س‌ه‌ر‌و‌یس	servis
س‌ه‌ر‌ز‌ه‌نیش	serzeniş
س‌ه‌ت	set
س‌ه‌وا‌ل	seval
س‌ه‌وا‌پ	sevap
س‌ه‌و‌ه‌ج‌ن	sevecen
س‌ه‌وی	sevi
س‌ه‌و‌غی	sevgi
س‌ه‌و‌غ‌ی‌لی	sevgili
س‌ه‌و‌ی‌ی‌ه	seviye
س‌ه‌و‌م‌ک	sevmek
س‌ه‌یا‌ه‌ا‌ت	seyahat
س‌ه‌ی‌ف	seyf
س‌ه‌ی‌ه‌ا‌ن	seyhan
س‌ه‌ی‌یر	seyir
س‌ه‌ی‌یس	seyis
س‌ه‌ی‌ر‌ک	seyrek
س‌ه‌ی‌یا‌ه	seyyah
س‌ه‌ی‌یا‌ل	seyyal
س‌ه‌ی‌ی‌یا‌ت	seyyiat
س‌ه‌ی‌ی‌ی‌ه	seyyie
س‌ی‌ب‌یا‌ن	sıbyan
س‌ی‌جا‌ک	sıcak
س‌ی‌جا‌ک‌لیک	sıcaklık
س‌ی‌چا‌ن	sıçan
س‌ی‌چ‌را‌ما	sıçrama
س‌ی‌چ‌را‌ی‌یش	sıçrayış
س‌ی‌فا‌ت	sıfat
س‌ی‌ه‌ه‌ا‌ت	sıhhat
س‌ی‌ه‌ه‌ی‌ی‌ه	sıhhiye
س‌ی‌ک‌ی‌ن‌تی	sıkıntı
س‌ی‌ک‌ما‌ک	sıkmak
س‌ی‌ک‌ما‌با‌ش	sıkımbabaş
س‌ی‌ک‌ی‌جا	sıkıca
س‌ی‌لا	sıla
س‌یر	sır
س‌ی‌را‌ت	sırat
س‌ی‌ر‌چا	sırça
س‌ی‌ر‌دا‌ش	sırdaş
س‌ی‌ر‌ی‌ق	sırık
س‌ی‌ر‌لی	sırlı
س‌ی‌ر‌لا‌ما‌ک	sırlamak
س‌ی‌ر‌ما	sırma
س‌ی‌ر‌ت	sırt
س‌ی‌ر‌ت‌لا‌ن	sırtlan
س‌ی‌س‌م‌یک	sismik
س‌ی‌ت‌م	sitem
س‌ی‌تا‌ی‌یش	sitayiş
س‌ی‌ت‌ه	site
س‌ی‌ت‌ر	sitr
س‌ی‌وا‌س‌لی	sivaslı
س‌ی‌و‌یل	sivil
س‌ی‌و‌ری	sivri
س‌ی‌و‌ر‌یل‌ت‌م‌ک	sivriltmek
س‌ی‌ا‌ه	siyah
س‌ی‌یا‌س‌ت	siyaset
س‌ی‌یا‌سی	siyasi
س‌ی‌ی‌ر	siyer
س‌ی‌ی‌م‌ک	siymek
س‌ی‌یو‌ن	siyon
س‌ی‌پ‌ر	siper
س‌ی‌پا‌ر‌یش	sipariş
س‌ی‌پا‌ه‌ی	sipahi
س‌ی‌را‌ی‌ت	sirayet
س‌ی‌ر‌ک	sirk
س‌ی‌ر‌کا‌د‌ی‌ی‌ن	sirkadiyen
س‌ی‌ر‌کو‌لا‌س‌یو‌ن	sirkülasyon
س‌ی‌رو‌ز	siroz
س‌ی‌س‌مولو‌جی	sismoloji
س‌ی‌س‌ت‌ما‌ت‌یز	sistematize
س‌ی‌س‌ت‌م	sistem
س‌ی‌س‌ت‌م‌لی	sistemli
س‌ی‌ت‌یل	sitil
س‌ی‌وا‌س	sivas
س‌ی‌و‌یل‌ج‌ه	sivilce
س‌ی‌و‌ری‌س‌ی‌ن‌ک	sivrisinek
س‌ی‌یا‌سا‌ل	siyasal
س‌ی‌یا‌ه‌ی‌لیک	siyahilik
س‌ی‌ی‌ر‌ی‌ن‌ه‌بی	siyer-i nebi
س‌ی‌ی‌ر‌ک‌یتا‌پ‌لری	siyer kitapları
س‌ی‌ی‌ک	siyek
س‌یز‌ج‌ه	sizce
س‌ی‌ی‌ری‌ق	sıyrık
س‌ی‌ی‌ری‌ل‌ما‌ک	sıyrılmak
س‌ی‌ی‌ر‌ی‌ن‌تی	sıyrıntı
س‌ی‌زی	sızı
س‌ی‌ز‌ما	sızma
س‌ی‌ز‌ما‌ک	sızmak
س‌کا	ska
س‌لو‌غا‌ن	slogan
س‌لا‌ی‌ت	slayt
سو‌ف‌را	sofra
سو‌فی	sofi
سو‌ف‌ی‌س‌تی‌ک‌ه	sofistike
سو‌فو	sofu
سو‌غو‌ق	soğuk
سو‌غو‌ق‌لو‌ق	soğukluk
سو‌غو‌ت‌ما	soğutma
سو‌غو‌ت‌ما‌ک	soğutmak
سو‌غا‌ن	soğan
سو‌کا‌ک	sokak
سو‌ک‌ما‌ک	sokmak
سو‌ل	sol
سو‌لا‌ک	solak
سو‌ل‌جو	solcu
سو‌ل‌گو‌ن	solgun
سو‌لو‌نو‌م	solunum
سو‌لو‌جا‌ن	solucan
سو‌مو‌ت	somut
سو‌ن‌با‌ه‌ا‌ر	sonbahar
سو‌ن‌دا	sonda
سو‌ن‌دا‌ج	sondaj
سو‌ن‌لو	sonlu
سو‌ن‌سز	sonsuz
سو‌ن‌سز‌لو‌ق	sonsuzluk
سو‌نو‌چ	sonuç
سو‌نو‌چ‌لا‌ن‌ما‌ک	sonuçlanmak
سو‌پا	sopa
سو‌ر‌غو	sorgu
سو‌ر‌غو‌لا‌ما	sorgulama
سو‌ر‌غو‌لا‌ما‌ک	sorgulamak
سو‌ر‌غو‌چ	sorguç
سو‌رو‌ن	sorun
سو‌رو‌م	sürüm
سو‌رو‌م‌لو	sorumlu
سو‌رو‌م‌لو‌ق	sorumluluk
سو‌رو‌ش‌تور‌ما	soruşturma
سو‌رو‌ش‌تور‌ما‌ک	soruşturmak
سو‌س	süs
سو‌س‌ی‌ا‌ل	sosyal
سو‌س‌ی‌ا‌ل‌ی‌س‌ت	sosyalist
سو‌س‌یولو‌جی	sosyoloji
سو‌س‌یولو‌غ	sosyolog
سو‌ی	soy
سو‌یا	soya
سو‌یا‌ق	soyak
سو‌ی‌لو	soylu
سو‌ی‌سز	soysuz
سو‌یو	soyu
سو‌یو‌ن	soyun
سو‌یو‌ت	soyut
سو‌یو‌ت‌لا‌ما	soyutlama
سو‌غو‌ت	söğüt
سو‌ک‌م‌ک	sökmek
سو‌م‌ه‌س‌تر	sömestr
سو‌ن‌مه	sönme
سو‌ن‌م‌ک	sönmek
سو‌نو‌م‌ل‌ن‌م‌ک	sönümlenmek
سو‌نو‌ک	sönük
سو‌نو‌م	sönüm
سو‌ن‌د‌ور‌م‌ک	söndürmek
سو‌نو‌ش	sönüş
سو‌ی‌ل‌م	söylem
سو‌ی‌ل‌م‌ک	söylemek
سو‌ی‌ل‌ن‌م‌ک	söylenmek
سو‌ز	söz
سو‌ز‌لو‌ک	sözlük
سو‌ز‌لو‌ک‌ج‌ه	sözlükçe
سو‌ز‌جو‌ک	sözcük
سو‌ز‌جو‌لو‌ق	sözcülük
سو‌لا‌ل‌ه	sülale
سو‌لو‌ک	sülük
سو‌لو‌س	sülüs
سو‌م‌بو‌ل	sümbül
سو‌م‌سو‌ک	sümsük
سو‌مو‌ک	sümük
سو‌ن‌گو	süngü
سو‌ن‌ن‌ت	sünnet
سو‌پ‌ر	süper
سو‌پو‌ر‌گ‌ه	süpürge
سو‌پو‌ر‌م‌ک	süpürmek
سو‌ر‌ه	süre
سو‌ر‌ه‌چ	süreç
سو‌ر‌گو‌ن	sürgün
سو‌ر‌م‌ک	sürlemek
سو‌ر‌م‌ه‌لی	sürmeli
سو‌ر‌ر‌ه‌آل	sürreal
سو‌ر‌ر‌ه‌آل‌ی‌س‌ت	sürrealist
سو‌رو‌ن‌گ‌ن	sürüngen
سو‌رو	sürü
سو‌رو‌جو	sürücü
سو‌رو‌جو‌لو‌ق	sürücülük
سو‌رو‌ک‌لو	sürüklü
سو‌رو‌ک‌ل‌م‌ک	sürüklemek
سو‌رو‌ل‌م‌ک	sürülmek
سو‌رو‌ن‌م‌ک	sürünmek
سو‌س‌ل‌مه	süsleme
سو‌س‌ل‌م‌ک	süslemek
سو‌ت	süt
سو‌ت‌جو	sütçü
سو‌ت‌لا‌چ	sütlaç
سو‌وا‌ری	süvari
سو‌و‌ت‌ر	süveter
سو‌ز‌گ‌چ	süzgeç
سو‌ز‌م‌ک	süzmek
شا‌فا‌ک	şafak
شا‌ه‌ا‌د‌ت	şahadet
شا‌ه‌ا‌د‌ت‌نا‌مه	şahadetname
شا‌ه‌ا‌نه	şahane
شا‌ه‌ی‌س	şahıs
شا‌ه‌یت	şahit
شا‌ه‌لا‌ن‌ما‌ک	şahlanmak
شا‌ه‌با‌ز	şahbaz
شا‌ه‌س‌ی‌ی‌ت	şahsiyet
شا‌ه‌س‌ی‌لیک	şahsilik
شا‌عیر	şair
شا‌عیرا‌نه	şairane
شا‌عیر‌لیک	şairlik
شا‌کا	şaka
شا‌کا‌غ	şakağ
شا‌کا‌لا‌ک	şakalak
شا‌ک‌ی‌لیک	şakilik
شا‌کیر	şakir
شا‌ک‌ی‌ر‌تی	şakırtı
شا‌ک‌را‌ک	şakrak
شا‌کول	şakul
شا‌ل	şal
شا‌ل‌وا‌ر	şalvar
شا‌ما‌ن	şaman
شا‌ما‌تا	şamata
شا‌م‌یل	şamil
شا‌م‌دا‌ن	şamdan
شا‌م‌پوا‌ن	şampuan
شا‌ن‌س	şans
شا‌ن‌س‌لی	şanslı
شا‌پ‌کا	şapka
شا‌پ‌لا‌ک	şaplak
شا‌را‌پ	şarap
شا‌را‌پ‌ن‌ل	şarapnel
شا‌ر‌جو‌ر	şarjör
شا‌ر‌ک	şark
شا‌ر‌کی	şarkı
شا‌ر‌ک‌ی‌جی	şarkıcı
شا‌ر‌ک‌ی‌یا‌ت	şarkiyat
شا‌ر‌ک‌ی‌یا‌ت‌چی	şarkiyatçı
شا‌ر‌ت	şart
شا‌ر‌ت‌نا‌مه	şartname
شا‌ر‌ت‌لی	şartlı
شا‌ر‌ج	şarj
شا‌ر‌ج‌لی	şarjlı
شا‌تا‌فا‌ت	şatafat
شا‌تا‌فا‌ت‌لی	şatafatlı
شا‌و‌ک	şavk
شا‌یا‌ک	şayak
شا‌ی‌ت	şayet
ش‌ه‌ب‌ک	şebek
ش‌ه‌ب‌ن‌م	şebnem
ش‌ه‌جا‌عا‌ت	şecaat
ش‌ه‌ج‌ر	şecer
ش‌ه‌ف‌فا‌ف	şeffaf
ش‌ه‌ها‌د‌ت	şehadet
ش‌ه‌ها‌د‌ت‌نا‌مه	şehadetname
ش‌ه‌ها‌د‌ت‌لی	şehadetli
ش‌ه‌ه‌با‌ل	şehbal
ش‌ه‌هیت	şehit
ش‌ه‌هیت‌لیک	şehitlik
ش‌ه‌هیر	şehir
ش‌ه‌هیر‌لی	şehirli
ش‌ه‌ه‌نا‌مه	şehname
ش‌ه‌ه‌نا‌ز	şehnaz
ش‌ه‌ه‌را	şehra
ش‌ه‌ه‌را‌زا‌ت	şehrazat
ش‌ه‌ه‌یر‌ج‌ی‌لیک	şehircilik
ش‌ه‌ه‌زا‌ده	şehzade
ش‌ه‌کا‌و‌ت	şekavet
ش‌ه‌ک‌یل	şekil
ش‌ه‌ک‌یل‌ج‌ی‌لیک	şekilcilik
ش‌ه‌ک‌یل‌سز	şekilsiz
ش‌ه‌ک‌یل‌ل‌ن‌د‌ر‌مه	şekillendirme
ش‌ه‌ک‌یل‌ل‌ن‌م‌ک	şekillenmek
ش‌ه‌ک‌یل‌ل‌ن‌د‌ر‌ج‌ی	şekillendirici
ش‌ه‌ک‌یل‌لی‌لیک	şekillilik
ش‌ه‌ک‌ر	şeker
ش‌ه‌ک‌ر‌لی	şekerli
ش‌ه‌ک‌ر‌سز	şekersiz
ش‌ه‌ک‌ر‌ل‌مه	şekerleme
ش‌ه‌ل‌ک	şelek
ش‌ه‌ما‌ت‌یک	şematik
ش‌ه‌م‌س‌ی‌ی‌ه	şemsiye
ش‌ه‌م‌س‌ی‌ی‌ه‌لی	şemsiyeli
ش‌ه‌ن	şen
ش‌ه‌ن‌لیک	şenlik
ش‌ه‌ن‌ل‌ن‌م‌ک	şenlenmek
ش‌ه‌ن‌ل‌ن‌د‌ر‌ج‌ی	şenlendirici
ش‌ه‌ر‌ه‌ف	şeref
ش‌ه‌ر‌ه‌ف‌ی‌ی‌ت	şerefiye
ش‌ه‌ر‌ه‌ف‌لی	şerefli
ش‌ه‌ر‌ه‌ف‌سز	şerefsiz
ش‌ه‌ر‌یا‌ت	şeriat
ش‌ه‌ر‌یا‌ت‌چی	şeriatçı
ش‌ه‌ر‌ه	şerh
ش‌ه‌ر‌ی‌ف	şerif
ش‌ه‌ر‌یت	şerit
ش‌ه‌ر‌ره	şerre
ش‌ه‌ر‌ه‌ه‌ت‌م‌ک	şerh etmek
ش‌ه‌ر‌ی‌ف‌ه	şerife
ش‌ه‌را‌عیت	şerait
ش‌ه‌ر‌ب‌ت	şerbet
ش‌ه‌ر‌ب‌ت‌چی	şerbetçi
ش‌ه‌ر‌ب‌ت‌لیک	şerbetlik
ش‌ه‌ر‌ه‌نا‌مه	şerhname
ش‌ه‌ر‌ه‌لی	şerhli
ش‌ه‌ر‌ه‌ل‌م‌ک	şerhlemek
ش‌ه‌ر‌ی‌ف‌لیک	şeriflik
ش‌ه‌و‌ک	şevk
ش‌ه‌و‌ک‌ت	şevket
ش‌ه‌و‌وا‌ل	şevval
ش‌ه‌ی	şey
ش‌ه‌ی‌ه	şeyh
ش‌ه‌ی‌ه‌لیک	şeyhlik
ش‌ه‌ی‌تا‌ن	şeytan
ش‌ه‌ی‌تا‌ن‌لیک	şeytanlık
ش‌ه‌ی‌تا‌نی	şeytani
ش‌ه‌ی‌تا‌ن‌جا	şeytanca
ش‌ه‌ی‌تا‌ن‌سز	şeytansız
ش‌ه‌ی‌تا‌ن‌لاش‌ما‌ک	şeytanlaşmak
ش‌ه‌ی‌تا‌ن‌ت	şeytanet
ش‌یا‌ر	şiar
ش‌ی‌فا	şifa
ش‌ی‌فا‌جی	şifacı
ش‌ی‌فا‌ه‌ا‌ن	şifahan
ش‌ی‌فا‌ه‌ی	şifahi
ش‌ی‌ف‌ره	şifre
ش‌ی‌ف‌ر‌لی	şifreli
ش‌ی‌ف‌ر‌سز	şifresiz
ش‌ی‌عیر	şiir
ش‌ی‌عیر‌س‌ل	şiirsel
ش‌ی‌عیر‌ی‌یا‌ت	şiiriyat
ش‌ی‌کا‌ی‌ت	şikayet
ش‌ی‌کا‌ی‌ت‌چی	şikayetçi
ش‌ی‌کا‌ی‌ت‌ه‌ت‌م‌ک	şikayet etmek
ش‌ی‌کا‌ی‌ت‌نا‌مه	şikayetname
ش‌ی‌کا‌ر	şikar
ش‌ی‌له	şile
ش‌ی‌ل‌ه‌ب‌ه	şilebe
ش‌ی‌ل‌ه‌پ	şilep
ش‌ی‌ما‌لی	şimali
ش‌ی‌ما‌ل	şimal
ش‌ی‌م‌د‌ی	şimdi
ش‌ی‌م‌ش‌ک	şimşek
ش‌ی‌م‌شیر	şimşir
ش‌ی‌نا‌سی	şinasi
ش‌ی‌نا‌س‌ی‌ی‌ه	şinasiye
ش‌ی‌پ‌شا‌ک	şipşak
ش‌ی‌را‌ز‌ه	şiraze
ش‌ی‌ر‌ک	şirk
ش‌ی‌ر‌ک‌ت	şirket
ش‌ی‌ر‌ک‌ت‌ل‌ش‌مه	şirketleşme
ش‌ی‌ر‌ک‌ت‌س‌ل	şirketsel
ش‌ی‌ر‌ین	şirin
ش‌ی‌ر‌ی‌ن‌ج‌ه	şirince
ش‌ی‌ر‌ی‌ن‌ک‌وی	şirinköy
ش‌ی‌ر‌ر‌ت	şirret
ش‌ی‌ر‌ز‌ی‌مه	şirzime
ش‌ی‌ش	şiş
ش‌ی‌ش‌ه	şişe
ش‌ی‌ش‌ک‌ین	şişkin
ش‌ی‌ش‌کو	şişko
ش‌ی‌ش‌ک‌ین‌لیک	şişkinlik
ش‌ی‌ش‌ل‌م‌ک	şişlemek
ش‌ی‌ش‌ما‌ن	şişman
ش‌ی‌ش‌ما‌ن‌لیک	şişmanlık
ش‌ی‌س‌ت	şist
ش‌ی‌و‌ه	şive
ش‌ی‌و‌ه‌سز	şivesiz
ش‌ی‌و‌ه‌کا‌ر	şivekâr
ش‌ی‌و‌ه‌سی	şivesi
ش‌ی‌و‌ه‌س‌ل	şivesel
ش‌ی‌و‌ه‌ج‌ی‌لیک	şivecilik
ش‌ی‌و‌ل‌ی‌لیک	şivlilik
ش‌نور‌ک‌ل	şnorkel
شو‌فور	şoför
شو‌فور‌لو‌ق	şöförlük
شو‌ک	şok
شو‌ک‌لا‌ما	şoklama
شو‌ک‌لا‌ن‌ما‌ک	şoklanmak
شو‌ک‌ه	şoke
شو‌م	şom
شو‌م‌آغ‌ی‌ز‌لی	şom ağızlı
شو‌س‌ه	şose
شو‌و	şov
شو‌و‌ن	şoven
شو‌و‌ن‌ی‌س‌ت	şovenist
شو‌ل‌ن	şölen
شو‌م‌یز	şömiz
شو‌م‌ی‌ن‌ه	şömine
شو‌وا‌ل‌ی‌ه	şövalye
شو‌ی‌له	şöyle
شو‌ی‌ل‌م‌ک	şöylemek
شو‌ی‌ل‌ه‌ک‌ی	şöyleki
شو	şu
شو‌ا	şua
شو‌ب‌ه	şube
شو‌با‌ت	şubat
شو‌ه	şuh
شو‌ه‌لو‌ق	şuhluk
شو‌ه‌ا‌ن‌ه	şuhane
شو‌ل‌ه	şule
شو‌مو‌ل‌لو	şumullü
شو‌را	şura
شو‌را‌لی‌ق	şuralık
شو‌را‌سی	şurası
شو‌رو‌پ	şurup
شو‌ت	şut
شو‌کو‌ر	şükür
شو‌ک‌ر‌ت‌م‌ک	şükretmek
شو‌ه‌دا	şüheda
شو‌ه‌دا‌لی‌ق	şühedalık
شو‌ک‌را‌ن	şükran
شو‌کو‌ر‌دو‌عا‌سی	şükür duası
شو‌مو‌ل	şümul
شو‌پ‌ه	şüphe
شو‌پ‌ه‌لی	şüpheli
شو‌پ‌ه‌سز	şüphesiz
شو‌پ‌ه‌ج‌ی	şüpheci
شو‌پ‌ه‌ل‌ن‌م‌ک	şüphelenmek
شو‌پ‌ه‌ج‌ی‌لیک	şüphecilik
شو‌پ‌ه‌دو‌ی‌ما‌ک	şüphe duymak
شو‌ور	şuur
شو‌ور‌لو	şuurlu
شو‌ور‌سز	şuursuz
شو‌ور‌آل‌تی	şuuraltı
شو‌هو‌د	şuhud
شو‌هو‌د‌ی‌ی‌ت	şuhudiyet
شو‌هو‌د‌نا‌مه	şuhudname
شو‌هو‌ب	şuhub
شو‌ه‌را	şuhra
شو‌ه‌ر‌ت	şuhret
شو‌هو‌د‌ی	şuhudi
شو‌هو‌د‌ی‌لیک	şuhudilik
شو‌هو‌ب‌ی‌ی‌ت	şuhubiyet
تا‌ک‌وا	takva
تا‌ه‌ا‌ر‌ت	taharet
تا‌ه‌ک‌ی‌کا‌ت	tahkikat
تا‌ه‌س‌یل	tahsil
تا‌ک‌د‌یم	takdim
تا‌ک‌د‌یر	takdir
تا‌ک‌ی‌پ	takip
تا‌ک‌س‌یم	taksim
تا‌ک‌س‌یرا‌ت	taksirat
تا‌ل‌ه‌ب‌ه	talebe
تا‌ل‌ه‌پ	talep
تا‌ل‌ت‌ی‌ف	taltif
تا‌ن‌ز‌یم	tanzim
تا‌ز‌یم	tazim
تا‌ز‌م‌ی‌نا‌ت	tazminat
ت‌ه‌ب‌ل‌ی‌غ	tebliğ
ت‌ه‌ج‌و‌ید	tecvid
ت‌ه‌ف‌سیر	tefsir
ت‌ه‌ف‌ه‌ک‌ور	tefekkür
ت‌ه‌ه‌د‌یت	tehdit
ت‌ه‌ه‌ل‌ک‌ه	tehlike
ت‌ه‌ک‌بیر	tekbir
ت‌ه‌ک‌ک‌ه	tekke
ت‌ه‌ک‌م‌یل	tekmil
ت‌ه‌ک‌ز‌ی‌پ	tekzip
ت‌ه‌لا‌ک‌ک‌ی	telakki
ت‌ه‌ما‌یو‌ل	temayül
ت‌ه‌م‌یز‌ل‌یک	temizlik
ت‌ه‌م‌ک‌ین	temkin
ت‌ه‌م‌س‌یل	temsil
ت‌ه‌ن‌س‌ی‌پ	tensip
ت‌ه‌پ‌ه	tepe
ت‌ه‌ر‌ب‌ی‌ی‌ه	terbiye
ت‌ه‌ر‌ج‌ی‌ه	tercih
ت‌ه‌ر‌د‌دو‌ت	tereddüt
ت‌ه‌ر‌ف‌ی	terfi
ت‌ه‌ر‌ه‌س	terhis
ت‌ه‌ر‌ک	terk
ت‌ه‌ر‌ت‌ی‌پ	tertip
ت‌ه‌س‌ب‌ی‌ه	tesbih
ت‌ه‌س‌ه‌ل‌لی	teselli
ت‌ه‌س‌ه‌ت‌ور	tesettür
ت‌ه‌سیر	tesir
ت‌ه‌س‌ل‌یم	teslim
ت‌ه‌س‌ل‌ی‌م‌ی‌ی‌ت	teslimiyet
ت‌ه‌س‌پ‌ی‌ه	tespih
ت‌ه‌س‌ت‌ی	testi
ت‌ه‌ش‌ب‌ی‌ه	teşbih
ت‌ه‌ش‌ه‌ک‌ور	teşekkür
ت‌ه‌ش‌ک‌یل	teşkil
ت‌ه‌ش‌ک‌ی‌لا‌ت	teşkilat
ت‌ه‌ش‌ر‌ی‌فا‌ت	teşrifat
ت‌ه‌ش‌ر‌ی‌ه	teşrih
ت‌ه‌ش‌و‌یک	teşvik
ت‌ه‌وا‌زو	tevazu
ت‌ه‌و‌ه‌ج‌و‌ه	teveccüh
ت‌ه‌و‌ف‌یک	tevfik
ت‌ه‌و‌ه‌ید	tevhid
ت‌ه‌و‌ه‌ید‌ی	tevhidi
ت‌ه‌و‌ه‌ید‌س‌ل	tevhidsel
ت‌ه‌و‌یل	tevil
ت‌ه‌و‌ک‌ی‌ف	tevkif
ت‌ه‌و‌ک‌ی‌فا‌ت	tevkifat
ت‌ه‌و‌را‌ت	tevrat
ت‌ه‌و‌ر‌ی‌ی‌ه	tevriye
ت‌ه‌و‌س‌ی	tevsi
ت‌ه‌و‌ز‌ی	tevzi
ت‌ه‌زا‌هو‌ر	tezahür
ت‌ه‌زا‌ت	tezat
ت‌ه‌ز‌ک‌ی‌ی‌ه	tezkiye
ت‌ه‌ز‌و‌یر	tezvir
ت‌ی‌ب‌ب‌ی‌ی‌ه‌لی	tıbbiyeli
ت‌ی‌ف‌یل	tıfıl
ت‌ی‌کا‌چ	tıkaç
ت‌ی‌ل‌س‌یم	tılsım
ت‌ی‌ما‌ر	tımar
ت‌ی‌ما‌ر‌ه‌ا‌ن‌ه	tımarhane
ت‌ی‌پ‌ک‌یبا‌س‌یم	tıpkıbasım
ت‌ی‌را‌ش	tıraş
ت‌ی‌ر‌نا‌ک	tırnak
ت‌ی‌ی‌ن‌ت	tıynet
ت‌ی‌غ	tığ
تا‌با‌ک	tabak
تا‌با‌ن	taban
تا‌ب‌یا‌ت	tabiat
تا‌ب‌ی‌ب‌ه	tabibe
تا‌ب‌ی‌پ	tabip
تا‌ب‌لا‌جی	tablacı
تا‌ب‌لو	tablo
تا‌بو‌ت	tabut
تا‌جیر	tacir
تا‌د‌یل	tadil
تا‌د‌ی‌لا‌ت	tadilat
تا‌ف‌س‌ی‌لا‌ت	tafsilat
تا‌غ‌ی‌یر	tağyir
تا‌ه‌ا‌ج‌جو‌د	tahaccüd
تا‌ه‌ا‌ک‌ک‌و‌ک	tahakkuk
تا‌ه‌ا‌م‌مو‌ل	tahammül
تا‌ه‌ا‌ر‌ت‌ل‌ن‌م‌ک	taharetlenmek
تا‌ه‌ک‌یم	tahkim
تا‌ه‌ل‌ی‌ی‌ه	tahliye
تا‌ه‌ل‌یل	tahlil
تا‌ه‌م‌ین	tahmin
تا‌ه‌س‌ی‌لا‌ت	tahsilat
تا‌ه‌س‌یس	tahsis
تا‌ه‌ت	taht
تا‌ه‌تا‌جی	tahtacı
تا‌کا	taka
تا‌ک‌د‌یر‌ی‌ا‌لاه‌ی	takdir-i ilahi
تا‌ک‌ی	takı
تا‌ک‌ی‌با‌ت	takibat
تا‌ک‌ل‌یت	taklit
تا‌ک‌ر‌یز	takriz
تا‌ک‌س‌یت	taksit
تا‌ک‌س‌یت‌ل‌ه	taksitle
تا‌ک‌ی‌یت	takyit
تا‌لا‌ک	talak
تا‌لا‌کا	talaka
تا‌لا‌ک‌لی	talaklı
تا‌لا‌س‌ه‌م‌ی	talasemi
تا‌لا‌ن	talan
تا‌لا‌س	talas
تا‌ل‌ه‌پ‌کا‌ر	talepkâr
تا‌ل‌یک	talik
تا‌ما	tama
تا‌ما‌ه	tamah
تا‌ما‌ه‌کا‌ر	tamahkâr
تا‌ما‌م	tamam
تا‌ما‌م‌ی‌ی‌ت	tamamiyet
تا‌ما‌ک	tamak
تا‌م‌یرا‌ت	tamirat
تا‌م‌یر‌ج‌ی	tamirci
تا‌م‌ل‌ی‌ق	tamlık
تا‌م‌پو‌ن	tampon
تا‌ن	tan
تا‌ن‌ه	tane
تا‌ن‌ه‌تا‌ن‌ه	tane tane
تا‌ن‌ی	tanı
تا‌ن‌ی‌ق	tanık
تا‌ن‌ی‌ق‌ل‌ی‌ق	tanıklık
تا‌ن‌ی‌م	tanım
تا‌ن‌ی‌ما‌ک	tanımak
تا‌ن‌ی‌ن‌ما	tanınma
تا‌ن‌یش‌ما	tanışma
تا‌ن‌ی‌ت‌یم	tanıtım
تا‌ن‌ز‌ی‌فا‌ت	tanzifat
تا‌و‌جو‌لو‌ق	taoculuk
تا‌پا‌ن	tapan
تا‌پ‌ی‌نا‌ک	tapınak
تا‌پ‌ما‌ک	tapmak
تا‌پو‌جو	tapucu
تا‌پو‌سز	tapusuz
تا‌را‌ف	taraf
تا‌را‌ف‌گ‌یر	tarafgir
تا‌را‌ف‌لی	taraflı
تا‌را‌ف‌سز	tarafsız
تا‌را‌س‌سو‌ت	tarassut
تا‌ر‌ی‌ف	tarif
تا‌ر‌ی‌کا‌ت	tarikat
تا‌ر‌ی‌ه‌ی	tarihi
تا‌ر‌ی‌ه‌چ‌ه	tarihçe
تا‌ر‌ی‌ه‌س‌ل	tarihsel
تا‌ر‌یز	tariz
تا‌ر‌ت‌ی	tartı
تا‌ر‌ت‌ما‌ک	tartmak
تا‌ر‌ت‌یش‌ما	tartışma
تا‌ر‌ت‌یش‌ما‌ک	tartışmak
تا‌س	tas
تا‌سا‌ر‌ی	tasarı
تا‌سا‌ر‌لا‌ما‌ک	tasarlamak
تا‌سا‌و‌و‌ر	tasavvur
تا‌سا‌و‌و‌ف	tasavvuf
تا‌سا‌و‌و‌ف‌ی	tasavvufi
تا‌س‌د‌یک	tasdik
تا‌س‌ف‌ی‌ی‌ه	tasfiye
تا‌س‌لا‌ک	taslak
تا‌س‌ن‌ی‌ف	tasnif
تا‌س‌و‌یر	tasvir
تا‌ش	taş
تا‌ش‌ی‌ما‌ک	taşımak
تا‌ش‌ی‌ما	taşıma
تا‌ش‌ی‌ر‌ما‌ک	taşırmak
تا‌ش‌ی‌ما‌ج‌ی‌ل‌ی‌ق	taşımacılık
تا‌ش‌را	taşra
تا‌ش‌را‌لی	taşralı
تا‌ش‌سز	taşsız
تا‌ش‌ل‌ی‌ق	taşlık
تا‌ش‌ک‌ین	taşkın
تا‌ش‌ما‌ک	taşmak
تا‌ش‌را‌ل‌ی‌ل‌ی‌ق	taşralılık
تا‌ش‌سز‌ل‌ی‌ق	taşsızlık
تا‌ت	tat
تا‌ت‌ی‌ل‌ه	tatile
تا‌ت‌یل	tatil
تا‌ت‌ل‌ی	tatlı
تا‌ت‌ما‌ک	tatmak
تا‌ت‌م‌ین	tatmin
تا‌وا	tava
تا‌وا‌ف	tavaf
تا‌وا‌ن	tavan
تا‌و‌یر	tavır
تا‌و‌یر‌آل‌ما‌ک	tavır almak
تا‌و‌یر‌کوی‌ما‌ک	tavır koymak
تا‌و‌یر‌تا‌ک‌ی‌ن‌ما‌ک	tavır takınmak
تا‌وا‌ف‌ی‌ی‌ه	tavafiye
تا‌و‌یز	taviz
تا‌و‌یز‌کا‌ر	tavizkâr
تا‌و‌لا	tavla
تا‌و‌لا‌ما‌ک	tavlamak
تا‌و‌س‌ی‌ی‌ه	tavsiye
تا‌ی‌ین	tayin
تا‌ی‌ین‌نا‌مه	tayinname
تا‌ی‌یا‌ر‌ه	tayyare
تا‌ی‌یا‌ر‌ه‌ج‌ی	tayyareci
تا‌ی‌یا‌ر‌ه‌ج‌ی‌لی‌ق	tayyarecilik
تا‌ی‌ی‌ب	tayyib
تا‌ی‌ی‌ب‌ه	tayyibe
تا‌ز‌ه	taze
تا‌ز‌ل‌ن‌م‌ک	tazelenmek
تا‌ز‌م‌ین	tazmin
تا‌ز‌م‌ی‌نا‌ت‌لی	tazminatlı
تا‌ز‌م‌ی‌نا‌ت‌سز	tazminatsız
تا‌ز‌ی	tazı
ت‌ه‌آم‌مو‌د‌ن	teammüden
ت‌ه‌ب‌د‌یل	tebdil
ت‌ه‌ب‌ل‌و‌غ	tebellüğ
ت‌ه‌ب‌ر‌رو‌ک‌ن	teberrüken
ت‌ه‌ب‌ر‌رو	teberru
ت‌ه‌جا‌و‌ز	tecavüz
ت‌ه‌ج‌ل‌لی	tecelli
ت‌ه‌ج‌م‌مو	tecemmu
ت‌ه‌ج‌س‌س	tecessüs
ت‌ه‌ج‌د‌دو‌ت	teceddüt
ت‌ه‌ج‌رو‌ب‌ه	tecrübe
ت‌ه‌ج‌رو‌ب‌ه‌لی	tecrübeli
ت‌ه‌دا‌ر‌یک	tedarik
ت‌ه‌دا‌ر‌یکا‌ت	tedarikat
ت‌ه‌دا‌و‌ی	tedavi
ت‌ه‌د‌بیر	tedbir
ت‌ه‌د‌بور	tedebbür
ت‌ه‌د‌دو‌پ	teeddüp
ت‌ه‌ع‌م‌مو‌ل	teemmül
ت‌ه‌ع‌سور	teessür
ت‌ه‌ع‌سو‌ف	teessüf
ت‌ه‌ف‌ه‌ک‌ور‌لو	tefekkürlü
ت‌ه‌ف‌عو‌ل	tefeül
ت‌ه‌ف‌ه	tefe
ت‌ه‌ف‌ه‌ع‌ک‌ور	tefeekkür
ت‌ه‌ف‌ر‌رو‌آ‌ت	teferruat
ت‌ه‌ف‌عو‌ل‌ه‌ت‌م‌ک	tefeül etmek
ت‌ه‌ف‌ر‌یکا	tefrika
ت‌ه‌ف‌ر‌یکا‌ج‌ی	tefrikacı
ت‌ه‌ف‌و‌یز	tefviz
ت‌ه‌ه‌ج‌یر	tehcir
ت‌ه‌ه‌د‌ید	tehdid
ت‌ه‌هیر	tehir
ت‌ه‌ه‌ل‌یل	tehlil
ت‌ه‌ه‌ل‌ک‌ه‌لی	tehlikeli
ت‌ه‌ه‌ل‌ک‌ه‌سز	tehlikesiz
ت‌ه‌کا‌ل‌ی‌ف	tekalif
ت‌ه‌کا‌مو‌ل	tekâmül
ت‌ه‌کا‌سور	tekasür
ت‌ه‌ک‌ب‌ی‌ه	tekbih
ت‌ه‌ک‌ف‌یر	tekfir
ت‌ه‌ک‌ک‌ه‌ل‌ش‌م‌ک	tekkeleşmek
ت‌ه‌ک‌ن‌یک	teknik
ت‌ه‌ک‌نولو‌ج‌ی	teknoloji
ت‌ه‌ک‌س‌ت‌یل	tekstil
ت‌ه‌ک‌ت‌ی‌پ	tektip
ت‌ه‌ک‌را‌ر	tekrar
ت‌ه‌لا‌ف‌ی	telafi
ت‌ه‌ل‌گ‌را‌ف	telgraf
ت‌ه‌ل‌م‌ی‌ه	telmih
ت‌ه‌ل‌ی‌ف	telif
ت‌ه‌ل‌ک‌ین	telkin
ت‌ه‌ل‌لی	telli
ت‌ه‌ل‌سز	telsiz
ت‌ه‌ل‌و‌یس	telvis
ت‌ه‌ما	tema
ت‌ه‌ما‌س	temas
ت‌ه‌م‌ب‌ل	tembel
ت‌ه‌م‌ب‌ی‌ه	tembih
ت‌ه‌م‌ین	temin
ت‌ه‌م‌ینا‌ت	teminat
ت‌ه‌م‌یز	temiz
ت‌ه‌م‌یز‌ل‌ی‌ک‌چ‌ی	temizlikçi
ت‌ه‌م‌ک‌ین‌لی	temkinli
ت‌ه‌م‌پو‌لو	tempolu
ت‌ه‌نا‌ک‌وز	tenakuz
ت‌ه‌ن‌ب‌ی‌ه	tenbih
ت‌ه‌ن‌ف‌فو‌س	teneffüs
ت‌ه‌ن‌ک‌یت	tenkit
ت‌ه‌ن‌ک‌یس	tenkis
ت‌ه‌ن‌ز‌ی‌ه	tenzih
ت‌ه‌پ‌ک‌ی	tepki
ت‌ه‌پ‌ک‌ی‌م‌ه	tepkime
ت‌ه‌را‌ک‌ک‌ی	terakki
ت‌ه‌ر‌جو‌م‌ه	tercüme
ت‌ه‌ر‌ف‌ی‌ی‌ه	terfiye
ت‌ه‌ر‌ک‌ی‌پ	terkip
ت‌ه‌ر‌ک‌ه‌ت‌م‌ک	terk etmek
ت‌ه‌ر‌ل‌یک	terlik
ت‌ه‌ر‌ما‌ل	termal
ت‌ه‌ر‌س	ters
ت‌ه‌ر‌ت‌ه‌میز	tertemiz
ت‌ه‌وا‌ج‌و‌ه	tevacüh
ت‌ه‌و‌د‌ی	tevdi
ت‌ه‌ز‌ه‌ک‌ور	tezekkür
ت‌ه‌ز‌ه‌ی‌پ	tezhip
ت‌ه‌ز‌ک‌ی‌ی‌ه‌ی‌ن‌ف‌س	tezkiye-i nefs
ت‌ه‌ز‌و‌یر‌ج‌ی	tezvirci
او‌چا‌ک	uçak
او‌چ‌ما‌ک	uçmak
او‌چو‌ش	uçuş
او‌چو‌ش‌جو	uçuşçu
او‌چو‌جو	uçucu
او‌چو‌رو‌م	uçurum
او‌چو‌ر‌ت‌ما	uçurtma
او‌چو‌ش‌ما	uçuşma
او‌چو‌شو‌لا‌ن	uçuşulan
او‌چو‌را‌ب‌یل‌م‌ه	uçurabilme
او‌چو‌رو‌جو‌لو‌ق	uçuruculuk
او‌چو‌شو‌ت‌ما‌ما‌ک	uçuşutmamak
او‌چا‌ن	uçan
او‌جو‌زا	ucuza
او‌جو‌ز	ucuz
او‌جو‌ز‌جا	ucuzca
او‌جو‌ز‌جو	ucuzcu
او‌جو‌ز‌لو‌ق	ucuzluk
او‌چو‌ک	uçuk
او‌چو‌ک‌لا‌ما‌ک	uçuklamak
او‌چو‌ک‌لا‌ش‌ما‌ک	uçuklaşmak
او‌چو‌رو‌م‌لو	uçurumlu
او‌فا‌ک	ufak
او‌فا‌ک‌چا	ufakça
او‌فا‌ک‌ل‌ی‌ق	ufaklık
او‌فا‌لا‌ن‌ما‌ک	ufalanmak
او‌فا‌ل‌ت‌ما‌ک	ufaltmak
او‌فو‌ق	ufuk
او‌فو‌ق‌سز	ufuksuz
او‌فو‌ک‌و	ufku
او‌فو‌ک‌و‌ن	ufkun
او‌ه‌ا‌ن‌ت	uhanet
او‌غ‌را‌ی‌یش	uğrayış
او‌غ‌را‌ما‌ک	uğramak
او‌غ‌رو‌ل‌یک	uğrulik
او‌غو‌ل‌دا‌ما‌ک	uğuldamak
او‌غو‌ل‌تو	uğultu
او‌غو‌ر	uğur
او‌غو‌ر‌لو	uğurlu
او‌غو‌ر‌سز	uğursuz
او‌غو‌ر‌تا‌ش‌ی	uğurtaşı
او‌لا‌ش	ulaş
او‌لا‌ش‌ما‌ک	ulaşmak
او‌لا‌ش‌یم	ulaşım
او‌لا‌ش‌ی‌ل‌ما‌ز	ulaşılmaz
او‌لا‌ش‌ت‌ر‌ما‌ک	ulaştırmak
او‌ل‌ه‌ما	ulema
او‌لو‌ف‌ه	ulufe
او‌لو‌ک	uluk
او‌لو‌لار	ulular
او‌لو‌لو‌ق	ululuk
او‌لو‌س	ulus
او‌لو‌سا‌ل	ulusal
او‌لو‌س‌چا	ulusça
او‌لو‌س‌لا‌ر‌آرا‌س‌ی	uluslararası
او‌لو‌ما‌ک	ulumak
او‌مو‌م‌ی	umumi
او‌مو‌م‌ی‌ی‌ت	umumiyet
او‌مو‌م‌ی‌ی‌ت‌ل‌ه	umumiyetle
او‌م‌ر‌ه	umre
او‌مو‌ت	umut
او‌مو‌ت‌لو	umutlu
او‌مو‌ت‌سز	umutsuz
او‌مو‌ر‌سا‌ک	umursak
او‌مو‌ر‌سا‌ما‌ک	umursamak
او‌مو‌ر‌سا‌ما‌ز	umursamaz
او‌مو‌ر‌سا‌ن‌ما‌ک	umursanmak
او‌مو‌ر‌سا‌ن‌ما‌ز	umursanmaz
او‌مو‌ر‌سا‌ما‌ز‌ل‌ی‌ق	umursamazlık
او‌ن‌جو	uncu
او‌ن‌دو‌ر‌ما	undurma
او‌ن‌دو‌ر‌ما‌ک	undurmak
او‌ن‌گا	unga
او‌نو‌ت‌ما‌ک	unutmak
او‌نو‌ت‌کا‌ن	unutkan
او‌نو‌ت‌کا‌ن‌ل‌ی‌ق	unutkanlık
او‌نو‌ت‌و‌ل‌ما‌ک	unutulmak
او‌نو‌ت‌و‌ل‌ما‌ز	unutulmaz
او‌نو‌ش‌ما‌ک	unuşmak
او‌ن‌وا‌ن	unvan
او‌پو‌ز‌و‌ن	upuzun
او‌را‌غا‌ن	urağan
او‌ر‌غا‌ن	urgan
او‌س	us
او‌سا‌ن‌چ	usanç
او‌سا‌ن‌د‌ر‌ما‌ک	usandırmak
او‌سا‌ن‌د‌ر‌ج‌ی	usandırıcı
او‌سا‌ن‌ما‌ک	usanmak
او‌سو‌ل	usul
او‌سو‌ل‌جا	usulca
او‌سو‌ل‌سز	usulsüz
او‌سو‌ل‌ی	usulî
او‌شا‌ک	uşak
او‌تا‌ن	utan
او‌تا‌ن‌ما‌ک	utanmak
او‌تا‌ن‌ما‌ز	utanmaz
او‌تا‌ن‌چ	utanç
او‌تا‌ن‌چ‌لی	utançlı
او‌تا‌ن‌چ‌سز	utançsız
او‌تو‌ر	utur
او‌غ‌را‌ش	uğraş
او‌غ‌را‌ش‌ما‌ک	uğraşmak
او‌غ‌را‌ش‌چ‌ی	uğraşçı
او‌غ‌را‌ش‌ی‌ل‌ما‌ک	uğraşılmak
او‌غ‌را‌ش‌ی‌م‌لی	uğraşımlı
او‌غو‌ر‌لا‌ما‌ک	uğurlamak
او‌مو‌ما	umuma
او‌مو‌ت‌سز‌جا	umutsuzca
او‌یا‌ک	uyak
او‌یا‌ک‌لی	uyaklı
او‌یا‌ک‌لا‌ما	uyaklama
او‌یا‌ر	uyar
او‌یا‌ر‌ما‌ک	uyarmak
او‌یا‌ر‌ی	uyarı
او‌یا‌ر‌ج‌ی	uyarıcı
او‌یا‌ر‌ی‌ل‌ما‌ک	uyarılmak
او‌ی‌غو‌لا‌ما‌ک	uygulamak
او‌ی‌غو‌لا‌ن‌ما‌ک	uygulanmak
او‌ی‌غا‌ر‌ل‌ی‌ق	uygarlık
او‌ی‌غا‌ر	uygar
او‌ی‌غو‌ن	uygun
او‌ی‌غو‌ن‌لو‌ق	uygunluk
او‌ی‌غو‌ن‌سز	uygunsuz
او‌ی‌کو	uyku
او‌ی‌کو‌سز	uykusuz
او‌ی‌کو‌لو	uykulu
او‌یو‌م	uyum
او‌یو‌ما‌ک	uyumak
او‌یو‌م‌لو	uyumlu
او‌یو‌م‌سز	uyumsuz
او‌یو‌ر	uyur
او‌یو‌ش‌ما‌ک	uyuşmak
او‌یو‌شو‌ک	uyuşuk
او‌یو‌شو‌ک‌لو‌ق	uyuşukluk
او‌یو‌ت‌ما‌ک	uyutmak
او‌یو‌ت‌و‌ل‌ما‌ک	uyutulmak
او‌زا‌غ‌ی	uzağı
او‌زا‌ک	uzak
او‌زا‌ک‌لا‌ش‌ما‌ک	uzaklaşmak
او‌زا‌ک‌ل‌ی‌ق	uzaklık
او‌زا‌ن‌ما‌ک	uzanmak
او‌زا‌ت‌ما‌ک	uzatmak
او‌زا‌ت‌ما	uzatma
او‌زا‌ت‌ی‌ل‌مو‌ش	uzatılmış
او‌زا‌ی	uzay
او‌زا‌ی‌لی	uzaylı
او‌ز‌لا‌ش‌ما‌ک	uzlaşmak
او‌ز‌لا‌ش‌ما	uzlaşma
او‌ز‌لا‌ش‌ت‌ر‌ما‌ک	uzlaştırmak
او‌ز‌ما	uzma
او‌ز‌ما‌ن	uzman
او‌ز‌ما‌ن‌ل‌ی‌ق	uzmanlık
او‌ز‌ما‌ن‌لا‌ش‌ما‌ک	uzmanlaşmak
او‌ز‌و‌ن	uzun
او‌ز‌و‌ن‌لو‌ق	uzunluk
او‌ز‌و‌ن‌جا	uzunca
او‌ز‌و‌و	uzuv
او‌ز‌و‌و‌سا‌ل	uzuvsal
او‌س‌لو	uslu
او‌سو‌ل‌سز‌ل‌ی‌ق	usulsüzlük
او‌میت	Ümit
او‌م‌م‌ت	Ümmet
او‌ل‌ف‌ت	Ülfet
او‌ز‌و‌ن‌تو	Üzüntü
او‌س‌تو‌ن	Üstün
او‌ز‌و‌م	Üzüm
او‌چ‌گ‌ن	Üçgen
او‌ج‌را	Ücra
او‌ر‌پ‌ر‌م‌ک	Ürpermek
او‌ج‌ر‌ت	Ücret
او‌ر‌ت‌یم	Üretim
او‌ر‌ت‌ک‌ن	Üretken
او‌ن‌ی‌و‌ر‌س‌ی‌ت‌ه	Üniversite
او‌ز‌و‌ل‌م‌ک	Üzülmek
او‌ن‌س‌ی‌ی‌ت	Ünsiyet
او‌ز‌ه‌ر‌ی‌ن‌ه	Üzerine
او‌س‌ت‌ل‌ن‌م‌ک	Üstlenmek
او‌ل‌ف‌ی	Ülfî
او‌و‌ه‌ی‌ل‌یک	Üveylik
او‌و‌ه‌ی‌س‌ی	Üveysi
او‌ش‌ن‌م‌ک	Üşenmek
او‌ش‌و‌م‌ک	Üşümek
او‌س‌کو‌دا‌ر	Üsküdar
او‌ر‌ک‌ک	Ürkek
او‌رو‌ن	Ürün
او‌ل‌ک‌ه	Ülke
او‌ل‌ف‌ت‌لی	Ülfetli
او‌ل‌ف‌ت‌ل‌یک	Ülfetlik
او‌س‌لو‌پ	Üslup
او‌ز‌گو‌ن	Üzgün
او‌م‌م‌ی	Ümmî
او‌ر‌یا‌ن	Üryan
او‌س‌لو‌ب‌ی	Üslubî
او‌ل‌ف‌ت‌ل‌ش‌م‌ک	Ülfetleşmek
او‌ن‌س	Üns
او‌م‌یت‌لی	Ümitli
او‌ل‌ف‌ت‌نا‌م‌ه	Ülfetnâme
او‌ی‌ه	Üye
او‌چ‌و‌ن‌جو	Üçüncü
او‌ز‌گو‌ن‌لو‌ق	Üzgünlük
او‌س‌لو‌بو	Üslubu
او‌ل‌ف‌ت‌غا‌ه	Ülfetgâh
او‌ت‌و	Ütü
او‌و‌ه‌ز	Üvez
او‌ل‌کو	Ülkü
او‌ل‌و‌ی	Ülvi
او‌ل‌ف‌ت‌پ‌ر‌و‌ر	Ülfetperver
او‌ش‌و‌ت‌م‌ک	Üşütmek
او‌س‌ت‌لو‌ق	Üstlük
او‌چ‌لو	Üçlü
او‌چ‌ل‌م‌ه	Üçleme
او‌ر‌ت‌ی‌ج‌ی	Üretici
او‌ر‌م‌ک	Üremek
او‌ز‌ن‌گ‌ی	Üzengi
او‌ر‌ک‌و‌تو‌جو	Ürkütücü
او‌س‌ت‌ل‌ن‌ی‌ج‌ی	Üstlenici
او‌و‌ه‌ی	Üvey
او‌ن‌ی‌و‌ر‌س‌ی‌ت‌ه‌لی	Üniversiteli
او‌س‌ت‌ل‌نیش	Üstleniş
او‌ر‌ک‌م‌ک	Ürkmek
او‌ل‌ف‌ت‌ل‌ن‌د‌ر‌م‌ک	Ülfetlendirmek
او‌س‌لو‌ب‌ی‌ی‌ت	Üslubiyet
او‌ز‌و‌ن‌تو‌سز	Üzüntüsüz
او‌ل‌ف‌ت‌ل‌ش‌ت‌ر‌م‌ک	Ülfetleştirmek
او‌م‌ی‌د‌ی‌ی‌ل‌ه	Ümidiyle
او‌م‌ی‌د‌ی‌ن‌ج‌ه	Ümidince
او‌ن‌س‌ی‌ی‌ت‌لی‌ل‌ی‌ق	Ünsiyetlilik
او‌س‌لو‌ب‌و‌ن‌جا	Üslubunca
او‌س‌کو‌دا‌ر‌لی‌ق	Üsküdarlık
او‌ل‌ک‌ر	Ülker
او‌ل‌ف‌ی‌لی‌ق	Ülfîlik
او‌ز‌ن‌گ‌ی‌ی‌ل‌ه	Üzengiyle
او‌س‌تا‌ت‌لی‌ق	Üstatlık
او‌ز‌گو‌ن‌لی‌ک‌ل‌ه	Üzgünlükle
او‌س‌لو‌ب‌و‌چ‌ه‌ش‌م	Üslubuçeşm
او‌ز‌و‌م‌جو‌لو‌ق	Üzümcülük
او‌چ‌ل‌م‌ه‌لی	Üçlemeli
او‌چ‌ل‌م‌ه‌سز	Üçlemesiz
او‌س‌ت‌و‌ن‌کو‌رو	Üstünkörü
او‌ل‌ف‌ت‌دا‌ر	Ülfetdâr
او‌ر‌ک‌و‌ت‌م‌ک	Ürkütmek
او‌سو‌ل‌لو	Üsullü
او‌چ‌لو‌ق	Üçlük
او‌ز‌و‌ن‌چ‌سز	Üzünçsüz
او‌ل‌ک‌ر‌ی	Ülkerî
او‌ل‌کو‌جو‌لو‌ق	Ülkücülük
او‌ز‌گو‌ن‌ج‌ه	Üzgünce
او‌م‌را‌ن	Ümran
او‌م‌م‌ی‌لی‌ق	Ümmilik
او‌چ‌گ‌ن‌ی‌م‌س‌ی	Üçgenimsi
او‌م‌ی‌ت‌سز‌ل‌ی‌ق	Ümitsizlik
او‌ر‌ک‌ک‌لی‌ق	Ürkeklik
او‌س‌لو‌پ‌سز‌لو‌ق	Üslupsuzluk
او‌رو‌ن‌سز‌لو‌ق	Ürünsüzlük
او‌س‌ت‌ن‌ج‌ی‌ل‌ی‌ق	Üstencilik
او‌ل‌ف‌ت‌سز	Ülfetsiz
او‌ل‌ف‌ت‌ل‌ی‌ل‌ی‌ق	Ülfetlilik
او‌ل‌ف‌ت‌ل‌میش	Ülfetlemiş
او‌س‌لو‌ب‌ی‌لی‌ق	Üslubîlik
او‌ر‌ت‌ی‌م‌سز	Üretimsiz
او‌ز‌و‌ن‌تو‌ی‌ل‌ه	Üzüntüyle
او‌ل‌ف‌ت‌غا‌ه‌لی‌ق	Ülfetgâhlık
او‌ل‌ف‌ت‌ل‌ن‌د‌ر‌م‌ه	Ülfetlendirme
او‌ل‌ف‌ت‌ل‌ن‌م‌ک	Ülfetlenmek
او‌ل‌ف‌ت‌ل‌ش‌یک	Ülfetleşik
او‌ل‌ف‌ت‌سز‌ل‌ش‌م‌ک	Ülfetsizleşmek
او‌ز‌و‌ن‌تو‌سز‌لو‌ق	Üzüntüsüzlük
او‌ر‌ک‌و‌تو‌جو‌لو‌ق	Ürkütücülük
او‌س‌ت‌ن‌ج‌ی‌ل‌ی‌ق‌ت‌ن	Üstencilikten
او‌م‌ی‌ت‌سز‌ل‌ی‌غ‌ه	Ümitsizliğe
او‌ل‌ک‌ه‌ج‌ه	Ülkece
او‌ل‌ک‌ه‌لی‌لی‌ق	Ülkelilik
او‌ل‌ک‌ه‌لار‌آرا‌س‌ی	Ülkelerarası
او‌ن‌ی‌و‌ر‌س‌ی‌ت‌ه‌ل‌ر	Üniversiteler
او‌ن‌ی‌و‌ر‌س‌ی‌ت‌ه‌لی‌لی‌ق	Üniversitelilik
او‌چ‌گ‌ن‌ل‌ر	Üçgenler
او‌رو‌ن‌ل‌ری	Ürünleri
او‌ر‌ت‌ی‌م‌لی‌ق	Üretimlik
او‌ل‌ف‌ت‌ل‌ش‌ت‌ر‌ی‌ل‌میش	Ülfetleştirilmiş
او‌ز‌و‌ل‌م‌م‌ک	Üzülmemek
او‌س‌ت‌ل‌ن‌ه‌ب‌یل‌م‌ک	Üstlenebilmek
او‌ر‌ت‌ی‌ل‌ه‌ب‌یل‌م‌ک	Üretilebilmek
او‌ر‌ک‌و‌ت‌و‌ل‌م‌ک	Ürkütülmek
او‌ر‌ک‌ک‌ج‌ه	Ürkekçe
او‌ز‌و‌ن‌ت‌و‌ل‌ن‌د‌ر‌م‌ک	Üzüntülendirmek
او‌ل‌ف‌ت‌ل‌ن‌د‌ر‌ی‌ل‌میش	Ülfetlendirilmiş
یا‌دی‌گا‌ر	yâdigâr
یا‌ر‌ن	yarın
یا‌ر	yar
یا‌کین	yakîn
یا‌ک‌ن‌لیک	yakınlık
یا‌با‌ن‌جی	yabancı
یا‌کا‌زا	yakaza
یا‌کوت	yakut
یا‌ل‌نز‌لیک	yalnızlık
یا‌ما‌لی	yamalı
یا‌م‌چی‌لی	yamçılı
یا‌نا‌ش‌ما	yanaşma
یا‌ن‌گ‌ن	yangın
یا‌ن‌س‌ی‌ما	yansıma
یا‌ن‌ک	yanık
یا‌را‌ت‌جی	yaratıcı
یا‌را‌ت‌لی‌ش	yaratılış
یا‌ر‌د‌م	yardım
یا‌ر‌د‌م‌جی	yardımcı
یا‌ر‌د‌م‌س‌و‌ر	yardımsever
یا‌ری	yarı
یا‌ر‌ن‌کی	yarınki
یا‌ری‌ش	yarış
یا‌ری‌ش‌ما	yarışma
یا‌سا	yasa
یا‌سا‌ک	yasak
یا‌سا‌ک‌لی	yasaklı
یا‌سا‌ل	yasal
یا‌س‌م‌ی‌ن	yasemin
یا‌س‌ی‌ن	yasin
یا‌س‌لا‌ن‌ماک	yaslanmak
یا‌س‌لی	yaslı
یا‌س‌سی	yassı
یا‌ش	yaş
یا‌شا‌م	yaşam
یا‌شا‌ماک	yaşamak
یا‌شا‌ن‌م‌ش‌لیک	yaşanmışlık
یا‌شا‌ن‌تی	yaşantı
یا‌شا‌ر	yaşar
یا‌ش‌لی	yaşlı
یا‌ت	yat
یا‌ت‌ری‌م	yatırım
یا‌ت‌ری‌م‌جی	yatırımcı
یا‌ت‌ک‌ن	yatkın
یا‌ت‌ماک	yatmak
یا‌ت‌سی	yatsı
یا‌و‌ر	yaver
یا‌و‌ز	yavuz
یا‌ز	yaz
یا‌ز‌گی	yazgı
یا‌زی	yazı
یا‌زی‌جی	yazıcı
یا‌زی‌لی	yazılı
یا‌ز‌ی‌م	yazım
یا‌ز‌ماک	yazmak
یا‌ز‌ما‌لی	yazmalı
یا‌ز‌ما	yazma
یا‌ی	yay
یا‌ی‌گ‌ن	yaygın
یا‌ی‌ل‌ما	yayılma
یا‌ی‌لا	yayla
یا‌ی‌ما‌جی	yaymacı
یا‌ی‌ماک	yaymak
یا‌ی‌وا‌ن	yayvan
یا‌ز‌گ‌لی	yazgılı
یا‌غ	yağ
یا‌غ‌جی	yağcı
یا‌غ‌لی	yağlı
یا‌غ‌ماک	yağmak
یا‌غ‌مور	yağmur
یا‌غ‌مور‌لوک	yağmurluk
یا‌غ‌سز	yağsız
یا‌غی‌ز	yağız
یا‌شا‌می	yaşamı
یا‌شا‌یا‌ن	yaşayan
یا‌شا‌ت‌ماک	yaşatmak
یا‌ش‌لیک	yaşlık
یا‌ش‌یت	yaşıt
یا‌ش‌لی‌لیک	yaşlılık
یا‌ش‌ماک	yaşmak
یا‌کا‌ر‌ما	yakarma
یا‌ک‌جی	yakıcı
یا‌ک‌لا‌ش‌ی‌م	yaklaşım
یا‌ک‌ماک	yakmak
یا‌کو‌پ	yakup
یا‌کو‌تی	yakutî
یا‌ک‌ی‌نی	yakînî
یا‌ک‌ی‌نا‌ت	yakînât
یا‌ک‌تی	yaktı
یا‌ک‌لا‌ش‌ت‌ری‌جی	yaklaştırıcı
یا‌ک‌لا‌ش‌ت‌ر‌ما	yaklaştırma
یا‌ک‌ن‌لا‌ش‌ما	yakınlaşma
یا‌کا‌را‌ن	yakaran
یا‌کا‌ری‌ش	yakarış
یا‌لا‌پ‌شا‌پ	yalapşap
یا‌ل‌ن	yalın
یا‌ل‌نز	yalnız
یا‌لا‌ن‌جی	yalancı
یا‌لا‌ن‌جی‌لیک	yalancılık
یا‌لا‌کا‌لیک	yalakalık
یا‌لا‌کا	yalaka
یا‌لا‌ماک	yalamak
یا‌ل‌پا	yalpa
یا‌ل‌پا‌لا‌ماک	yalpalamak
یا‌ل‌چن	yalçın
یا‌ل‌دز	yaldız
یا‌ل‌وا‌ری‌ش	yalvarış
یا‌ل‌وا‌ر‌ماک	yalvarmak
یا‌ل‌ن‌لیک	yalınlık
یا‌ما‌چ	yamaç
یا‌مول‌ما	yamulma
یا‌موک	yamuk
یا‌ما‌ماک	yamamak
یا‌ما‌ج‌ن	yamacın
یا‌نا‌ر‌دا‌غ	yanardağ
یا‌نا‌ش‌ک	yanaşık
یا‌نا‌ش‌ماک	yanaşmak
یا‌ن‌ل‌ت‌ماک	yanıltmak
یا‌ن‌ل‌سا‌ما	yanılsama
یا‌ن‌ل‌تی	yanıltı
یا‌ن‌ل‌گی	yanılgı
یا‌ن‌ت	yanıt
یا‌ن‌ت‌لا‌ماک	yanıtlamak
یا‌ن‌با‌ش	yanıbaş
یا‌ن‌ل‌ت‌جی	yanıltıcı
یا‌ن‌س‌ت‌جی	yansıtıcı
یا‌ن‌س‌ت‌ماک	yansıtmak
یا‌پ	yap
یا‌پ‌ی	yapı
یا‌پ‌جی	yapıcı
یا‌پ‌ت	yapıt
یا‌پ‌ی‌م	yapım
یا‌پ‌لی	yapılı
یا‌پ‌ماک	yapmak
یا‌پ‌ما	yapma
یا‌پ‌را‌ک	yaprak
یا‌پ‌را‌ک‌لی	yapraklı
یا‌پا‌ی	yapay
یا‌پا‌یا‌ل‌نز	yapayalnız
یا‌پا‌ی‌لیک	yapaylık
یا‌پ‌ش‌کا‌ن	yapışkan
یا‌پ‌ش‌ماک	yapışmak
یا‌پ‌ش‌ما	yapışma
یا‌پ‌ش‌ت‌ری‌جی	yapıştırıcı
یا‌را	yara
یا‌را‌ب‌بی	yarabbi
یا‌را‌دا‌ن	yaradan
یا‌را‌دا‌ن‌لیک	yaradanlık
یا‌را‌لی	yaralı
یا‌را‌ر‌لا‌ن‌ماک	yararlanmak
یا‌را‌ر‌سز	yararsız
یا‌را‌ر‌لی	yararlı
یا‌را‌ت‌ماک	yaratmak
یا‌را‌ت‌ی‌م	yaratım
یا‌را‌ت‌ل‌م‌ش	yaratılmış
یا‌را‌ت‌کا‌ن	yaratkan
یا‌ری‌م	yarım
یا‌ری‌م‌جی	yarımcı
یا‌ر‌ن‌گون	yarıngün
یا‌ری‌ش‌ما‌جی	yarışmacı
یا‌ری‌ش‌ماک	yarışmak
یا‌ری‌ی‌ل	yarıyıl
یا‌س	yas
یا‌سا‌لی	yasalı
یا‌سا‌ل‌لیک	yasallık
یا‌شا‌م‌سا‌ل	yaşamsal
یا‌شا‌ن‌م‌ش	yaşanmış
یا‌شا‌ن‌ماک	yaşanmak
یا‌ش‌لا‌ن‌ماک	yaşlanmak
یا‌تا‌غا‌ن	yatağan
یا‌تا‌ک	yatak
یا‌تا‌لا‌ک	yatalak
یا‌ت‌ر‌ماک	yatırmak
یا‌ت‌سی‌لیک	yatsılık
یا‌ت‌تی	yattı
یا‌ی‌ل‌ماک	yayılmak
یا‌ی‌م	yayım
یا‌ی‌ن	yayın
یا‌ی‌ن‌جی	yayıncı
یا‌ی‌ن‌لا‌ماک	yayınlamak
ی‌گا‌نه	yegâne
ی‌کون	yekûn
ی‌عی‌س	yeis
ی‌ک‌پا‌ره	yekpare
ی‌ک‌تا	yekta
ی‌ک‌ن‌ه‌سا‌ک	yeknesak
ی‌ک‌دی‌گ‌ر	yekdiğer
ی‌ر	yer
ی‌را‌ل‌تی	yeraltı
ی‌ر‌چ‌ه‌ک‌ی‌می	yerçekimi
ی‌ره‌ل	yerel
ی‌ری‌نه	yerine
ی‌ر‌له‌ش‌که	yerleşke
ی‌ر‌له‌ش‌ی‌م	yerleşim
ی‌ر‌لی	yerli
ی‌ر‌سز	yersiz
ی‌ر‌او‌ستو	yerüstü
ی‌سا‌ری	yesarî
ی‌ت‌ر	yeter
ی‌ت‌ر‌سز	yetersiz
ی‌تی	yeti
ی‌ت‌ی‌م	yetim
ی‌ت‌ی‌م‌ها‌نه	yetimhane
ی‌ت‌ی‌ن‌م‌ه‌ک	yetinmek
ی‌ت‌ک‌ی‌لی	yetkili
ی‌ت‌کی	yetki
ی‌ت‌ک‌ی‌ن	yetkin
ی‌ت‌م‌ز‌لی‌ک	yetmezlik
ی‌ت‌ی‌ش‌ک‌ی‌ن	yetişkin
ی‌ت‌ی‌ش‌م‌ه‌ک	yetişmek
ی‌ت‌ی‌ش‌ت‌ری‌م‌ه‌ک	yetiştirmek
ی‌لا‌ن	yılan
ی‌ل‌گ‌ی‌ن	yılgın
ی‌ل‌دز	yıldız
ی‌ل‌در‌ما‌ک	yıldırmak
ی‌ل‌در‌ما	yıldırma
ی‌ل‌دو‌ن‌و‌می	yıldönümü
ی‌ل‌گی	yılgı
ی‌ل‌ما‌ک	yılmak
ی‌ل‌با‌شی	yılbaşı
ی‌ل‌کی	yılkı
ی‌ت‌ی‌ک	yitik
ی‌ت‌م‌ه‌ک	yitmek
ی‌ت‌ی‌ر‌مه	yitirme
یو‌ک	yük
یو‌ک‌لا‌ما	yoklama
یو‌ک‌سو‌ل	yoksul
یو‌ک‌سو‌ل‌لو‌ک	yoksulluk
یو‌ک‌لو‌ک	yokluk
یو‌ک‌سا	yoksa
یو‌ل	yol
یو‌ل‌جو	yolcu
یو‌ل‌جو‌لو‌ک	yolculuk
یو‌ل‌دا‌ش	yoldaş
یو‌ل‌لا‌ر	yollar
یو‌ل‌لو‌ک	yolluk
یو‌ل‌ما‌ک	yolmak
یو‌ل‌و‌ن‌ما‌ک	yolunmak
یو‌ن‌تو	yontu
یو‌ن‌ت‌ما‌ک	yontmak
یو‌رو‌ل‌ما‌ک	yorulmak
یو‌رو‌م	yorum
یو‌رو‌م‌جو	yorumcu
یو‌رو‌م‌لا‌ما‌ک	yorumlamak
یو‌ر‌غا‌ن	yorgan
یو‌ر‌غو‌ن	yorgun
یو‌ر‌غو‌ن‌لو‌ک	yorgunluk
یو‌غو‌ن	yoğun
یو‌غو‌ن‌لا‌ش‌ما‌ک	yoğunlaşmak
یو‌غو‌ن‌لو‌ک	yoğunluk
یو‌ز	yüz
یو‌ز‌لا‌ش‌ما‌ک	yozlaşmak
یو‌ز‌لا‌ش‌ما	yozlaşma
یو‌دو‌م	yudum
یو‌ف‌کا	yufka
یو‌م‌شا‌ک	yumuşak
یو‌م‌رو‌ک	yumruk
یو‌م‌رو‌ک‌لا‌ش‌ما	yumruklaşma
یو‌مو‌ک	yumuk
یو‌م‌ور‌تا	yumurta
یو‌ن‌ما‌ک	yunmak
یو‌ر‌دا	yurda
یو‌ر‌ت	yurt
یو‌ر‌ت‌لو‌ک	yurtluk
یو‌ر‌ت‌تا‌ش	yurttaş
یو‌ت‌ما‌ک	yutmak
یو‌وا	yuva
یو‌وا‌ک	yuvak
یو‌ج‌ه	yüce
یو‌ج‌ه‌ل‌ت‌م‌ه‌ک	yüceltmek
یو‌ک‌ل‌ه‌م‌ه‌ک	yüklemek
یو‌ک‌ل‌ه‌ی‌جی	yükleyici
یو‌ک‌لو	yüklü
یو‌ک‌س‌ه‌ک	yüksek
یو‌ک‌س‌ل‌م‌ه‌ک	yükselmek
یو‌ک‌س‌لی‌ش	yükseliş
یو‌ک‌س‌ل‌ت‌م‌ه‌ک	yükseltmek
یو‌ک‌سو‌ن‌م‌ه‌ک	yüksünmek
یو‌ن	yün
یو‌زه	yüze
یو‌ز‌ه‌ی	yüzey
یو‌ز‌ه‌ی‌س‌ه‌ل	yüzeysel
یو‌ز‌گو‌رو‌م‌لو‌گو	yüzgörümlüğü
یو‌ز‌کا‌را‌سی	yüzkarası
یو‌ز‌ل‌ه‌ش‌م‌ه‌ک	yüzleşmek
یو‌ز‌سز	yüzsüz
یو‌زو‌ک	yüzük
یو‌زو‌ستو	yüzüstü
یو‌ز‌ل‌ه‌ش‌مه	yüzleşme
یو‌ز‌ه‌ی‌جی‌لی‌ک	yüzeycilik
یو‌ز‌ر	yüzer
یو‌ز‌گ‌ه‌چ	yüzgeç
یو‌ز‌ده	yüzde
یو‌ز‌د‌ه‌لی‌ک	yüzdelik
یو‌ز‌مه	yüzme
یو‌زو‌جو	yüzücü
یو‌زو	yüzü
یو‌ز‌ی‌ل	yüzyıl
یو‌ز‌یو‌زه	yüzyüze
یو‌ر‌ه‌ک‌لی‌لی‌ک	yüreklilik
یو‌ر‌ه‌ک‌ل‌ن‌د‌ی‌ر‌مه	yüreklendirme
یو‌ر‌ه‌ک	yürek
یو‌ر‌ه‌گی	yüreği
یو‌ر‌ه‌ک‌ت‌ن	yürekten
یو‌رو‌م‌ه‌ک	yürümek
یو‌رو‌ت‌م‌ه‌ک	yürütmek
یو‌رو‌یو‌ش	yürüyüş
یو‌رو‌ر‌لو‌ک	yürürlük
یو‌رو‌ر	yürür
یو‌رو‌ر‌لو‌ک‌ته	yürürlükte
زاب‌طه	zabıta
زاف‌یت	zafiyet
زفر	zafer
زاه‌ده	zahide
زحمت‌سز	zahmetsiz
زاهر	zâhir
زاه‌ت	zahit
ظرف‌یت	zarfiyet
زایف	zayıf
زایف‌لق	zayıflık
زبان‌ی	zebani
زده‌لن‌مه‌ک	zedelenmek
زم‌ه‌شری	zemahşerî
زم‌زم	zemzem
زنگ‌ن	zengin
زنگ‌ن‌لق	zenginlik
زن‌ی	zennî
زن‌ه	zenne
ذوق‌ات	zevkiyat
ذوق‌سز	zevksiz
زوات	zevat
زهر‌لن‌مه‌ک	zehirlenmek
زهر‌سز	zehirsiz
زهر‌ج‌لق	zehircilik
زبان‌لق	zebanlık
زبان‌یت	zebaniyet
زبان‌ی‌لق	zebanîlik
زبان‌له	zebella
زده‌لن‌مه	zedelenme
زده‌سز‌لق	zedesizlik
زکات‌لق	zekatlık
ذکر‌یا	zekeriya
ذکر‌مه‌ک	zikretmek
ذکر‌الله	zikrullah
ذق‌زق	zikzak
ضد‌یت	zıddıyet
ضقم	zıkkım
ضقم‌لن‌مه‌ک	zıkkımlanmak
ضپلای‌ش	zıplayış
ضپل‌مه‌ک	zıplamak
ضد	zıt
ضد‌لق	zıtlık
ضوان‌دن	zıvanadan
ضوان‌دن چق‌مه‌ک	zıvanadan çıkmak
ضبن	zıbın
زنا	zina
زنه‌ر	zinhar
زیرا	zira
زیراع‌ت	zirâat
زیراع‌ت‌چی	zirâatçi
زیروه	zirve
زیاده‌سی‌له	ziyadesiyle
زیاف‌ت	ziyafet
زیاک‌ر	ziyakar
زیا	ziya
زیار‌ت	ziyaret
زیار‌ت‌چی	ziyaretçi
زیار‌ت‌گاه	ziyaretgâh
زین‌ت	zînet
زین‌ت‌سز	ziynetsiz
زین‌ت‌لی	ziynetli
زیا‌الله	ziyaullah
ذکر‌ده‌لن	zikredilen
ذکر‌ی دایم	zikri daim
ضپقن	zıpkın
ضپلای‌ن	zıplayan
زاه‌رن	zâhiren
زنگ‌ن‌له‌ش‌مه‌ک	zenginleşmek
ذکر‌مه	zikretme
ضد‌نه	zıddına
زبور	zebûr
ضندق	zındık
ضندق‌لق	zındıklık
ذل	zül
ذل‌ت	zillet
ذل‌ذورنه	zilzurna
ذندان	zindan
ذر‌زپ	zirzop
ذر‌ه	zirh
ذفاف	zifaf
ذفیری	zifiri
ذفاف گجه‌سی	zifaf gecesi
ذفت	zift
ذفت‌لی	ziftli
ذگوت	zigot
ذکر اه‌لی	zikir ehli
زکات ور‌مه‌ک	zekat vermek
ضرر‌سز	zararsız
ضرورت حالی	zaruret hali
ضرور‌تن	zarureten
زمانه اوی‌مه‌ک	zamana uymak
ضمیر‌چی	zamirci
زاه‌رده	zahirde
ضدی‌ت	zıddîyet
ذکر‌دن	zikreden
ذکر‌ولون‌مه‌ک	zikrolunmak
ذکر‌ی گه‌چن	zikri geçen
زاهری	zâhirî
زاویه	zâviye
ذاکر	zâkir
زایی	zâyi
ظالم‌لق	zalimlik
زای‌ات	zâyiat
زبان‌لر	zebaniler
ذکر حلقه‌سی	zikir halkası
ذکر‌الله مج‌لسی	zikrullah meclisi
زاو‌للی	zavallı
زاویه‌لی	zaviyeli
ذر	zar
ظریف‌لق	zariflik
زمان‌ل‌مه	zamanlama
زمان‌له	zamanla
زمان‌لی	zamanlı
ضروری اح‌تیاج	zarurî ihtiyaç
ضروری سب‌پ	zarurî sebep
ضروری شرط	zarurî şart
زکات‌له ت‌میز‌لن‌مه‌ک	zekatla temizlenmek
ضد‌یت‌لی	zıddıyetli
ذکر‌مات‌ق	zikirmatik
ذکر‌مه حالی	zikretme hali
ذکر‌ی	zikrî
ظرافت‌لی	zarafetli
زمک‌له	zamkla
زمان‌اوستو	zamanüstü
زمان‌نده	zamanında
ضرور‌یت	zarûrîyet
ظالم‌انه	zâlimâne
زایی اول‌موش	zâyi olmuş
ذل‌ف‌قار	zülfikâr
ذپ‌په	züppe
ذپ‌په‌جه	züppece
ذر‌فا	zürefa
ذهره	zühre
ذهره ییل‌دزی	zühre yıldızı
ذمر‌وت	zümrüt
ذمره	zümre
ذهت	züht
ذهت حیاتی	züht hayatı
ذلال	zülal
ذلف	zülf
ذل‌ف‌قاری	zülfikarî
ذل‌ق‌ر‌ن‌ین	zülkarneyn
ذل‌یه‌ها	züleyha
ذل‌یه‌ه‌لق	züleyhalık
ذلوف	zülüf
ذل‌ج‌ن‌ه‌ین	zülcenaheyn
ذل‌ج‌ن‌ه‌ین‌لق	zülcenaheynlik
ذل‌ق‌ر‌ن‌ین‌لق	zülkarneynlik
ذل‌ال‌جلال	zü'l-celâl
ذل‌ال‌جلال و‌ال‌اکرام	zü'l-celâl ve'l-ikrâm
ذل‌ج‌باب	zülcebab
ذلال گبی	zülal gibi
ذلال سو	zülal su
ذمر‌وت گبی	zümrüt gibi
ذهد	zühd
ذهدی	zühdî
زاهد‌لق	zahidlik
زمان تون‌لی	zaman tüneli
زمان ق‌ورم‌ی	zaman kavramı
زمان یول‌جول‌غو	zaman yolculuğu
زمان م‌فهومو	zaman mefhumu
زکات ور‌ن	zekat veren
زکات اه‌لی	zekât ehli
ذکی چوج‌ق	zeki çocuk
ضروری غ‌دا	zaruri gıda
ظالم‌جه	zalimce
ضرر‌نه	zararına
ضرر‌ی یوق	zararı yok
ضرر ور‌مه‌ک	zarar vermek
ضروری اح‌تیاج‌لر	zaruri ihtiyaçlar'
اوکولا	okula
کیدیوروم	gidiyorum
چونکی	çünkü
صنامم	sınavım
وار	var
بن	ben
اييم	iyiyim
الله‌ا	allah'a
شكور	şükür
سن	sen
نصلسن	nasılsın
ياردِم	yardım
اَتسن	etsin
اشلرينز	işleriniz
كولاي	kolay
اولسون	olsun
گونش	güneş
بُگون	bugün
چوق	çok
اركن	erken
دوغدو	doğdu
هوا	hava
اسندى	ısındı
اوقيوروم	okuyorum
چونكى	çünkü
بيلگيمى	bilgimi
ارتيرمك	artırmak
ايستيوروم	istiyorum
سنى	seni
سَويوروم	seviyorum
قلبيم	kalbim
هپ	hep
سنى‌يله	seninle
حايرلى	hayırlı
صباحلر	sabahlar
گونونوز	gününüz
بركتلى	bereketli
اَويم	evim
اوزاق	uzak
اورايا	oraya
كتمم	gitmem
اوزون	uzun
سورر	sürer
يارِن	yarın
ياغمور	yağmur
ياغاجاق	yağacak
بو	bu
يوزدن	yüzden
طرلايه	tarlaya
كتميه‌ليم	gitmeyelim
كوزَل	güzel
دشاري‌دا	dışarıda
يورويش	yürüyüş
يپالم	yapalım
راضى	razı
ياردمنز	yardımınız
دَغَرلئى‌دى	değerliydi
چوربا	çorba
صجاق	sıcak
براز	biraz
صوغوماسنى	soğumasını
بَكلَيَليم	bekleyelim
گجه	gece
يلدزلر	yıldızlar
پارليور	parlıyor
كوك‌يُزى	gökyüzü
كورونيو‌ر	görünüyor
همن	hemen
كليوروم	geliyorum
صادجه	sadece
اشيمى	işimi
بترَيَيم	bitireyim
شكورلر	şükürler
اشلريم	işlerim
يولوندا	yolunda
كتى	gitti
قلممى	kalemimi
ماسانن	masanın
اوزره‌نده	üzerinde
اونوتتوم	unuttum
قپييى	kapıyı
آچق	açık
برقمشسن	bırakmışsın
رُزگار	rüzgar
گرمش	girmiş
پازاردن	pazardan
تازه	taze
ميوه	meyve
آلدم	aldım
جكتينى	ceketini
گييمى	giymeyi
اونوتمه	unutma
سرن	serin
چوجكلر	çocuklar
بحچده	bahçede
توپ	top
اوينيور	oynuyor
كلبالق	kalabalık
سُككلر	sokaklar
بنى	beni
يوردو	yordu
ينى	yeni
كومشولر	komşular
دُن	dün
تاشندى	taşındı
صباح	sabah
ترن	tren
زماننده	zamanında
گلدی	geldi
كتابچىدن	kitapçıdan
آلدوك	aldık
آقشام	akşam
يمه‌ينده	yemeğinde
بالق	balık
دى	di
دُوَردكى	duvardaki
تابلويو	tabloyu
كيم	kim
استى	astı
مكتوبو	mektubu
پُستا	posta
قوطسونه	kutusuna
آتر	atar
مى‌سن	mısın
البيسنى	elbiseni
اوتولمه‌يى	ütülemeyi
اونوتموشسون	unutmuşsun
بهاردا	baharda
چيچكلر	çiçekler
آچنجه	açınca
هر	her
يَر	yer
كوزَللشيور	güzelleşiyor
صندليه‌يى	sandalyeyi
پنجرهنن	pencerenin
يانىنه	yanına
قويدوم	koydum
آناحتَر	anahtar
جَبنده	cebinde
اولابلير	olabilir
تكرار	tekrar
اغرنجیلر	öğrenciler
درسَه	derse
سسسيزجه	sessizce
گِردى	girdi
ياستغن	yastığın
آلتىنه	altına
نوت	not
برقمش	bırakmış
مرديوَنلردن	merdivenlerden
دقّتلئ	dikkatli
اينمليسن	inmelisin
گونلك	günlük
توتمك	tutmak
روحوما	ruhuma
ائى	iyi
گَليور	geliyor
كوتوفانده	kütüphanede
كِمسه	kimse
قونوشمويوردو	konuşmuyordu
صِناودن	sınavdan
اونجه	önce
دِنلنمليسن	dinlenmelisin
ايكقبيلر	ayakkabılar
قاپنن	kapının
ياننده	yanında
دوريور	duruyor
تاتيلده	tatilde
بول	bol
فوتوغراف	fotoğraf
چكتك	çektik
دَركيى	dergiyi
ايچنه	içine
شمسييني	şemsiyeni
آلمادن	almadan
دشارى	dışarı
چقمه	çıkma
چانتنن	çantanın
فَرمُوارى	fermuarı
بوزولموش	bozulmuş
آدانن	odanın
دُوارلرى	duvarları
رنكده‌يدى	renkteydi
اوتوبوس	otobüs
ترميناله	terminale
گچ	geç
بوزدولابنده	buzdolabında
ليمون	limon
قالمامش	kalmamış
پارماقلرين	parmakların
صوغوقتن	soğuktan
مورارمش	morarmış
آرقدكى	arkadaki
صندوق	sandık
اسكى	eski
طوزلويدى	tozluydu
چالار	çalar
اركندن	erkenden
چالدى	çaldı
كلبالكدا	kalabalıkta
جوزداننى	cüzdanını
دُشورموشسون	düşürmüşsün
بيليترلرى	biletleri
گيشهدن	gişeden
آل	al
مشسن	mişsin
تليفونون	telefonun
شارژى	şarjı
بيتمش	bitmiş
آچلميور	açılmıyor
قولوندكى	kolundaki
شك	şık
بيرامدا	bayramda
بويوكلريمزى	büyüklerimizi
زيارت	ziyaret
اَتتك	ettik
آلدىغيم	aldığım
حالى	halı
آدَيه	odaya
ياقشدى	yakıştı
دشاريدن	dışarıdan
گلن	gelen
سس	ses
قورقوتتو	korkuttu
اليدكى	elindeki
قلاس	kalas
لارى	ları
گاراجه	garaja
تشيدم	taşıdım
تِلوِيزيوندا	televizyonda
ايلگينچ	ilginç
بَلقسل	belgesel
ايزلدك	izledik
اَولودا	avluda
كدلر	kediler
ايچن	için
سو	su
برقللمش	bırakılmış
اَلديوَنلرنى	eldivenlerini
چكمجَه	çekmeceye
كويمى	koymayı
چمنلرن	çimenlerin
چپلَك	çıplak
آياقلا	ayakla
يورودو	yürüdü
مطبخدا	mutfakta
زيتينياعى	zeytinyağı
قاونوزه	kavanoza
دكولدو	döküldü
چكيجِن	çekicin
ساپى	sapı
گوشمش	gevşemiş
دقّت	dikkat
اَت	et
يلباشنده	yılbaşında
كس	kes
بيربِرنه	birbirine
هديه	hediye
وردى	verdi
تماًمن	tamamen
دوغال	doğal
مالزملرله	malzemelerle
يپل	yapıl
مش	miş
كرلنكچلر	kırlangıçlar
يووا	yuva
يپمك	yapmak
دونمش	dönmüş
بهارتلرى	baharatları
دولابن	dolabın
اَن	en
اوسْت	üst
رَفنه	rafına
پارماقلقلرن	parmaklıkların
آرسى	arası
فرنن	fırının
جامى	camı
قرلمش	kırılmış
يَلَيينى	yeleğini
گييمشن	giymişsin
فرق	fark
اَتدن	ettin
مى	mi
كَربوزون	karpuzun
ايچى	içi
قرمزى	kırmızı
تطليدى	tatlıydı
آيين	ayın
ايشىغى	ışığı
گجهيى	geceyi
آيدنلاتتى	aydınlattı
باوولون	bavulun
قولپى	kulpu
يريندن	yerinden
چقمش	çıkmış
قلن	kalın
پرده‌يى	perdeyi
پنجره‌يه	pencereye
آستلر	astılar
ماكارنه	makarna
فازلا	fazla
پيشنجه	pişince
لَپه	lapa
اولدو	oldu
اينشاءَت	inşaat
آلنه‌نه	alanına
اذنسز	izinsiz
گيريلمز	girilmez
كوله	kule
اولدوقچه	oldukça
يوكسك	yüksek
اينشاءَ	inşa
اَدل	edil
دفينه‌نين	definenin
يرى‌نى	yerini
حريته‌دن	haritadan
بولدوك	bulduk
قيافتلرين	kıyafetlerin
اتيكتى	etiketi
حالا	hâlâ
دالغالر	dalgalar
قَيالكَره	kayalıklara
سرت	sert
وورويوردو	vuruyordu
موتُر	motor
بيردن	birden
دوردو	durdu
شاشردى	şaşırdı
فِدانلر	fidanlar
طوراغه	toprağa
دقّتلجه	dikkatlice
يَرلشتيريلدى	yerleştirildi
تطليلرن	tatlıların
اوسته‌نه	üstüne
پودره	pudra
سَيرپيلمشتى	serpilmişti
جاميلرده	camilerde
ازان	ezan
سسى	sesi
يانقىلانيووردو	yankılanıyordu
ايپلك	iplik
ماكارايه	makaraya
دوزگون	düzgün
ساريلممش	sarılmamış
لامبانن	lambanın
تترِيوُردو	titriyordu
يورغان	yorgan
آغر	ağır
تاشماقده	taşımakta
زورلندم	zorlandım
رانزه	ranza
دِميرلرى	demirleri
گچيردامايا	gıcırdamaya
باشلدى	başladı
قورو	kuru
فاصوليَه	fasulye
آقشمدن	akşamdan
اصلاتلمش	ıslatılmış
آلتن	altın
بيلزك	bilezik
صندقن	sandığın
كوشه‌سنده‌يدى	köşesindeydi
شيشه‌نن	şişenin
قاپاغنى	kapağını
سقىجه	sıkıca
قاپت	kapat
چواته	cıvata
آناحتَرى	anahtarı
تاقم	takım
چانتسنده‌يدى	çantasındaydı
ترموسون	termosun
ايچنده	içinde
ايچجك	içecek
كوركلَه	kürekle
قارى	karı
تميزلمه‌يه	temizlemeye
باشلدم	başladım
گچمن	göçmen
قوشلر	kuşlar
كُك‌يُزونو	gökyüzünü
دولدورموشدو	doldurmuştu
دولوناي	dolunay
آيدنلاتيوُردو	aydınlatıyordu
طوحوملرى	tohumları
سرائلَه	sırayla
سَيرپتك	serptik
اسكَلَتن	iskeletin
يپسى	yapısı
صاغلامدى	sağlamdı
بورولرن	boruların
طيكانمش	tıkanmış
منتشسى	menteşesi
كپچه‌يله	kepçeyle
چامورو	çamuru
كناره	kenara
كاكتوسون	kaktüsün
دكنلرى	dikenleri
سيوْرىدى	sivriydi
فوسفورلو	fosforlu
قلم‌له	kalemle
اشارتلنمشتى	işaretlenmişti
دوغمنن	düğmenin
رنكى	rengi
گُملَكه	gömleğe
اويميور	uymuyor
آسانسور	asansör
قطه	kata
اولاشتغنده	ulaştığında
چقاردى	çıkardı
چزگلى	çizgili
يرينه	yerine
كَرلى	kareli
ترجيح	tercih
اتتم	ettim
اَل	el
فَنَرى	feneri
ضعيف	zayıf
ايشق	ışık
وِريوُردو	veriyordu
ثابِت	sabit
تليفون	telefon
آرتق	artık
پك	pek
قولانلميور	kullanılmıyor
آناحتارلك	anahtarlık
چكمجسنده	çekmecesinde
قالدى	kaldı
رنكلى	renkli
بالونلر	balonlar
تاوانه	tavana
آسلمشتى	asılmıştı
قسهدكى	kasadaki
بَلقهلر	belgeler
مُهُورلنمشتى	mühürlenmişti
دن	dün
یورولدوم	yoruldum
اشلرمي	işlerimi
بترديم	bitirdim
خَلیفَه‌نِ	halifenin
اَمریله	emriyle
اُردو	ordu
سَفَره	sefere
چُقدی	çıktı
پادشاه	padişah
عَادَلَتله	adaletle
حُکم	hükmetti
اِتدی	etti
سَرایده	sarayda
بویوک	büyük
بیر	bir
مَشورَت	meşveret
مَجلِسی	meclisi
قورولدُ	kuruldu
داوایې	davayı
تی‌تیزلکله	titizlikle
اِنجلدی	inceledi
وَزیر	vezir
دیواندَکی	divandaki
قَراری	kararı
سُلطانا	sultana
سوندُ	sundu
تَبَعا	tebaa
پادشاهه	padişaha
صَداقَتله	sadakatle
باغلیدې	bağlıydı
نَقّاش	nakkaş
جامی‌نین	caminin
قُبّه‌سینه	kubbesine
سوسلملَر	süslemeler
یَپدی	yaptı
رِسالده	risalede
تَصَوُّفی	tasavvufî
مَسائلر	meseleler
ایشلنمشدی	işlenmişti
زِیارت	ziyaret
صِرَسِنده	sırasında
تُربه‌ده	türbede
دُعا	dua
اِدیلدی	edildi
مَرحوم	merhum
شهزادنِين	şehzadenin
جَنازه‌سی	cenazesi
تُرَنله	törenle
قالدیرلدی	kaldırıldı
روضهٔ	ravza-i
مُطَهّره‌یه	mutahhara'ya
گیدن	giden
قافله	kafile
یولا	yola
دَفتَردار	defterdar
مالیه	maliye
ایشلَریله	işleriyle
ایلغیلنِردی	ilgilenirdi
حَرَمدَکی	haremdeki
جَاری‌یلر	cariyeler
تعلیم	eğitimi
آلردی	alırdı
اِجازَتنامه‌سی	icazetnamesi
اولماین	olmayan
مُدَرّس	müderris
مَدرَسِده	medresede
دَرس	ders
وِرَمَزدی	veremezdi
ذِمّتینه	zimmetine
مال	mal
گئچی‌رن	geçiren
گورِولی	görevli
عَزل	azledildi
مِعمار	mimar
كُلیه‌یه	külliyeye
ظَریف	zarif
شادروان	şadırvan
اکلدی	ekledi
تَحرير	tahrir
دَفتَری	defteri
يَنی	yeni
باشدان	baştan
يازلدی	yazıldı
فَتوایې	fetvayı
حَلقله	halkla
پَیلاشتی	paylaştı
یولجولره	yolculara
بارنما	barınma
امکانى	imkânı
سوناردی	sunardı
سَنجق‌بیگی	sancakbeyi
ولایتې	vilayeti
آساییش	asayiş
ایچینده	içinde
یؤنَتدی	yönetti
چوجقلر	çocuklar
باحچده	bahçede
اوینیور	oynuyor
مطللر	mutlular
مسیفرلریمز	misafirlerimiz
یمکلری	yemekleri
حضرلایالیم	hazırlayalım
كتاب	kitap
قومك	okumak
انسانه	insana
حضور	huzur
وئرر	verir
بیلگیسینی	bilgisini
ارتیرر	artırır
اِنْ شَآءَ	inşallah
اللّٰهْ	allah
عٰاقِبَتْ	akıbet
خَيْرْ	hayır
اۏلُورْ	olur
شا	şa
عاقبت	akıbet
خير	hayır
الور	olur
ان شا	inşa
ان شاء	inşallah
ان شاء الله	inşallah
عاقبت خير	akıbet hayır
خير اۏلور	hayır olur
عاقبت خير اۏلور	akıbet hayır olur
اِنْ شَآءَ اللّٰهْ عٰاقِبَتْ خَيْرْ اۏلُورْ	inşallah akıbet hayır olur
ان شاء الله عاقبت خير الور	inşallah akıbet hayır olur
ان شاء الله عاقبت خير اۏلور	inşallah akıbet hayır olur
حُسْنِ	güzel
خَطِّيڭِزْ	yazınız
نَه	ne
قَدَرْ	kadar
دَە	da
زَرِيفْ	zarif
خطيڭز	yazınız
قدر	kadar
دە	da
زريف	zarif
حُسْنِ خَطِّيڭِزْ نَه قَدَرْ دَە زَرِيفْ	güzel yazınız ne kadar da zarif
حسن خطيڭز نه قدر دە زريف	güzel yazınız ne kadar da zarif
مَشْكُورْ	teşekkür
مشكور	teşekkür
شُكْراً	teşekkürler
شكرا	teşekkürler
عَفْواً	rica ederim
عفوا	rica ederim
مَرْحَباً	merhaba
مرحبا	merhaba
سَلام	selam
سلام	selam
سَبَاح	sabah
سباح	sabah
مَسَاء	akşam
مساء	akşam
لَيْل	gece
ليل	gece
نَهَار	gündüz
نهار	gündüz
يَوْم	gün
يوم	gün
مَطْبَخ	mutfak
مطبخ	mutfak
انسان	insan
انا	ben
هذا	bu
البيت	ev
كبير	büyük
كيف	nasıl
حالك	halin
حالكم	haliniz
عليكم	aleyküm
وعليكم	ve aleyküm
اقرا	okuyorum
يكتب	yazıyor
تحب	seviyor
اولادها	çocuklarını
احب	seviyorum
القراءة	okumayı
كثيرا	çok
مجتهد	çalışkan
ذاهب	gidiyorum
الى	doğru
المدرسة	okul
على	üzerinde
الطاولة	masa
الطعام	yemek
في	içinde
الام	anne
الطالب	öğrenci
الدرس	ders
الكتاب	kitap
مساء خير	iyi akşamlar
صباح خير	günaydın
كيف حالك	nasılsın
كيف حالكم	nasılsınız
السلام عليكم	selamün aleyküm
وعليكم السلام	aleyküm selam
الحمد لله	elhamdülillah
البيت كبير	ev büyük
هذا طالب	bu öğrenci
هذا طالب مجتهد	bu çalışkan öğrenci
انا اقرا	ben okuyorum
انا اقرا كتابا	ben kitap okuyorum
انا اقرا كتابا في البيت	ben evde kitap okuyorum
الطالب يكتب	öğrenci yazıyor
الطالب يكتب الدرس	öğrenci dersi yazıyor
الام تحب	anne seviyor
الام تحب اولادها	anne çocuklarını seviyor
انا احب	ben seviyorum
انا احب القراءة	ben okumayı seviyorum
انا احب القراءة كثيرا	ben okumayı çok seviyorum
انا ذاهب	ben gidiyorum
انا ذاهب الى	ben doğru gidiyorum
انا ذاهب الى المدرسة	ben okula gidiyorum
الكتاب على	kitap üzerinde
الكتاب على الطاولة	kitap masada
انا احب الطعام	ben yemeği seviyorum
انا احب الطعام كثيرا	ben yemeği çok seviyorum
انا ادرس	ben çalışıyorum
انا ادرس في الجامعة	ben üniversitede çalışıyorum
انا اشتري	ben satın alıyorum
انا اشتري الخبز	ben ekmek satın alıyorum
انا اذهب	ben gidiyorum
انا اذهب الى السوق	ben pazara gidiyorum
انا اكتب	ben yazıyorum
انا اكتب رسالة	ben mektup yazıyorum
انا اشرب	ben içiyorum
انا اشرب الماء	ben su içiyorum
انا اكل	ben yiyorum
انا اكل الطعام	ben yemek yiyorum
انا انام	ben uyuyorum
انا انام في الليل	ben gece uyuyorum
انا استيقظ	ben uyanıyorum
انا استيقظ في الصباح	ben sabah uyanıyorum
ادرس	çalışıyorum
الجامعة	üniversite
اشتري	satın alıyorum
الخبز	ekmek
اذهب	gidiyorum
السوق	pazar
اكتب	yazıyorum
رسالة	mektup
اشرب	içiyorum
الماء	su
اكل	yiyorum
انام	uyuyorum
الليل	gece
استيقظ	uyanıyorum
الصباح	sabah
السيارة	araba
الطائرة	uçak
القطار	tren
الحافلة	otobüs
الدراجة	bisiklet
الطريق	yol
الشارع	sokak
المدينة	şehir
القرية	köy
البلد	ülke
العالم	dünya
السماء	gökyüzü
الشمس	güneş
القمر	ay
النجوم	yıldızlar
البحر	deniz
النهر	nehir
الجبل	dağ
الغابة	orman
الحديقة	bahçe
الاب	baba
الاخ	kardeş
الاخت	kız kardeş
الجد	dede
الجدة	nine
العم	amca
العمة	hala
الخال	dayı
الخالة	teyze
الابن	oğul
الابنة	kız
الزوج	koca
الزوجة	karı
الصديق	arkadaş
الجار	komşu
الطبيب	doktor
المعلم	öğretmen
المهندس	mühendis
التاجر	tüccar
الاحمر	kırmızı
الازرق	mavi
الاخضر	yeşil
الاصفر	sarı
الاسود	siyah
الابيض	beyaz
الرمادي	gri
البرتقالي	turuncu
البنفسجي	mor
الوردي	pembe
البني	kahverengi
واحد	bir
اثنان	iki
ثلاثة	üç
اربعة	dört
خمسة	beş
ستة	altı
سبعة	yedi
ثمانية	sekiz
تسعة	dokuz
عشرة	on
مائة	yüz
الف	bin
اليوم	bugün
البارحة	dün
غدا	yarın
الاسبوع	hafta
الشهر	ay
السنة	yıl
الوقت	zaman
الساعة	saat
الدقيقة	dakika
الثانية	saniye
الطقس	hava
الحار	sıcak
البارد	soğuk
الممطر	yağmurlu
المشمس	güneşli
الغيوم	bulutlu
الريح	rüzgar
الثلج	kar
البرد	soğuk
الحر	sıcak
هذه	bu
ابي	babam
امي	annem
اخي	kardeşim
صديقي	arkadaşım
جاري	komşum
هو	o
كان	idi
سيكون	olacak
جميل	güzel
مشرقة	parlak
متلألئة	parıldıyor
عالي	yüksek
اسوق	sürüyorum
اركب	biniyorum
اسافر	seyahat ediyorum
اعيش	yaşıyorum
اسكن	oturuyorum
كل	her
مع	ile
عائلتي	ailem
الحمراء	kırmızı
الصيف	yaz
الشتاء	kış
الخريف	sonbahar
الربيع	ilkbahar
الكتب	kitaplar
الرسالة	mektup
بالسيارة	arabayla
في الحديقة	bahçede
كل يوم	her gün
من السوق	pazardan
اختي	kız kardeşim
اسود	siyah
ابيض	beyaz
المكتبة	kütüphane
لاقرا	okumak için
الجديدة	yeni
الخضروات	sebze
الفواكه	meyve
المطعم	restoran
اللغة	dil
العربية	Arapça
لاشاهد	görmek için
الطيور	kuşlar
نعمة	nimet
الاسلام	islam
بسم	adıyla
الرحمن	esirgeyen
الرحيم	bağışlayan
شاء	dilerse
نذهب	gideceğiz
المسجد	cami
اللهم	allahım
صل	salat et
سبحان	tesbih ederim
لا	yok
اله	ilah
الا	başka
قوماق	okumak
بنه	bana
هم	hem
سكون	huzur
ويرييور	veriyor
